15 18 18 18 18 18 18 18 18 18 18 18 18 18 18 18 18 18 18 18 18 18 18 18 20 
16 9 9 0 3 3 3 3 3 3 3 3 3 3 3 3 3 6 9 9 9 9 9 9 21 
16 9 9 1 4 4 4 4 4 4 4 4 4 4 4 4 4 7 9 9 9 9 9 9 21 
16 9 9 1 4 4 4 4 4 4 4 4 4 4 4 4 4 7 9 9 9 9 9 9 21 
16 9 9 1 4 4 4 4 4 4 4 4 4 4 4 4 4 7 9 9 9 9 9 9 21 
16 9 9 1 4 4 4 4 4 4 4 4 4 4 4 4 4 7 9 9 9 9 9 9 21 
16 9 9 1 4 4 4 4 4 4 4 4 4 4 4 4 4 7 9 9 9 9 9 9 21 
16 9 9 1 4 4 4 4 4 4 4 4 4 4 4 4 4 4 11 9 9 9 9 9 21 
16 9 9 1 4 4 4 4 4 4 4 4 4 4 4 4 4 7 9 9 9 9 11 9 21 
16 9 9 1 4 4 4 4 4 4 4 4 4 4 4 4 4 7 9 9 9 9 9 9 21 
16 9 9 1 4 4 4 4 4 4 4 4 4 4 4 4 4 7 9 9 9 9 9 9 21 
16 9 9 1 4 4 4 4 4 4 4 4 4 4 4 4 4 4 11 9 9 9 9 9 21 
16 9 9 1 4 4 4 4 4 4 4 4 4 4 4 4 4 7 9 9 9 9 9 9 21 
16 9 9 1 4 4 4 4 4 4 4 4 4 4 4 4 4 7 9 9 9 9 9 9 21 
16 9 9 1 4 4 4 4 4 4 4 4 4 4 4 4 4 7 9 9 9 11 9 9 21 
16 9 9 1 4 4 4 4 4 4 4 4 4 4 4 4 4 7 9 9 9 9 9 9 21 
16 9 9 1 4 4 4 4 4 4 4 4 4 4 4 4 4 7 9 9 9 9 9 9 21 
16 9 9 1 4 4 4 4 4 4 4 4 4 4 4 4 4 7 9 9 13 9 9 9 21 
16 9 9 1 4 4 4 4 4 4 4 4 4 4 4 4 4 7 9 9 9 9 9 9 21 
16 9 9 1 4 4 4 4 4 4 4 4 4 4 4 4 4 7 9 9 9 9 9 9 21 
16 9 9 1 4 4 4 4 4 4 4 4 4 4 4 4 4 7 9 9 9 9 9 9 21 
16 9 9 1 4 4 4 4 4 4 4 4 4 4 4 4 4 7 9 9 9 9 9 9 21 
16 9 9 1 4 4 4 4 4 4 4 4 4 4 4 4 4 7 9 9 9 9 9 9 21 
16 9 9 2 5 5 5 5 5 5 5 4 5 5 5 5 5 8 9 9 9 9 9 9 21 
17 19 19 19 19 19 19 19 19 19 19 19 19 19 19 19 19 19 19 19 19 19 19 19 22 
