15 18 18 18 18 18 18 18 18 18 18 18 18 18 18 18 18 18 18 18 18 18 18 18 20 
16 9 9 9 9 9 9 9 9 9 9 9 9 9 9 9 9 9 9 9 9 9 9 9 21 
16 0 3 3 3 3 3 3 3 3 3 3 3 3 3 3 3 3 3 3 3 3 6 9 21 
16 1 4 4 23 4 4 4 4 4 4 4 4 4 25 4 4 4 4 23 4 4 7 9 21 
16 1 4 4 4 4 4 23 4 4 4 4 4 23 23 4 4 4 4 25 23 4 7 9 21 
16 1 4 23 4 4 4 4 4 4 4 4 4 4 4 4 4 4 4 4 4 4 7 9 21 
16 1 4 4 4 4 4 4 4 23 4 4 4 4 4 4 4 25 4 4 4 4 7 9 21 
16 1 23 4 23 25 4 4 4 4 4 4 23 4 4 4 4 4 4 4 4 4 7 9 21 
16 1 4 4 4 4 4 23 4 4 4 4 4 4 4 4 4 4 4 23 4 4 7 9 21 
16 1 4 4 23 4 4 4 4 4 23 4 4 4 4 4 4 4 4 4 4 23 7 9 21 
16 1 4 4 4 23 4 4 4 4 4 4 4 4 4 4 4 4 4 4 4 4 7 9 21 
16 1 4 4 4 4 4 4 4 23 4 4 4 4 4 4 4 4 4 4 4 4 7 9 21 
16 1 4 4 4 4 4 4 4 23 4 23 4 4 4 4 23 4 4 4 4 4 7 9 21 
16 1 4 4 23 23 4 23 4 4 25 23 4 4 23 4 4 4 4 4 4 4 7 9 21 
16 1 4 4 4 23 4 4 23 4 4 4 4 4 4 4 4 4 25 4 23 4 7 9 21 
16 1 23 4 4 4 4 4 23 4 4 4 23 4 4 4 4 4 4 4 4 25 7 9 21 
16 1 4 4 4 4 4 4 4 4 4 4 4 4 23 4 4 4 4 4 4 4 7 9 21 
16 1 4 4 23 4 4 4 4 4 4 4 4 4 4 4 4 4 4 4 4 4 7 9 21 
16 1 4 4 23 4 4 4 4 4 4 4 4 4 4 23 4 4 4 4 4 4 7 9 21 
16 1 4 4 4 4 4 23 4 23 4 4 4 25 4 4 4 4 4 4 4 4 7 9 21 
16 1 4 4 23 4 4 4 4 4 4 4 4 4 4 4 4 4 4 4 25 4 7 9 21 
16 2 5 5 5 5 5 5 5 5 5 5 5 5 5 5 5 5 5 5 5 5 8 9 21 
16 9 9 9 9 9 9 9 9 9 9 9 9 9 9 9 9 9 9 9 9 9 9 9 21 
16 9 9 9 9 9 9 9 9 9 9 9 9 9 9 9 9 9 9 9 9 9 9 9 21 
17 19 19 19 19 19 19 19 19 19 19 19 19 19 19 19 19 19 19 19 19 19 19 19 22 
