15 18 18 18 18 18 18 18 18 18 18 18 18 18 18 18 18 18 18 18 18 18 18 18 20 
16 9 9 9 9 9 9 9 9 9 9 9 9 9 9 9 9 9 9 9 11 9 9 9 21 
16 9 9 9 9 9 9 9 9 9 9 9 9 9 9 9 9 9 9 9 9 9 9 9 21 
16 0 3 3 3 3 3 3 3 3 3 3 3 3 3 3 3 3 3 3 3 3 3 3 21 
16 1 4 4 4 23 4 4 4 4 4 4 4 4 4 4 4 4 4 4 23 4 4 23 21 
16 4 4 23 4 4 4 23 4 4 4 4 25 4 23 4 4 4 4 4 4 4 4 4 21 
16 1 4 4 4 4 25 4 4 4 23 4 25 4 23 4 4 4 4 23 4 4 4 4 21 
16 1 4 4 4 4 23 4 4 4 4 25 4 4 4 4 4 23 4 4 4 4 23 23 21 
16 1 4 4 4 4 4 4 25 4 23 4 4 4 23 23 4 4 4 4 4 4 4 4 21 
16 1 4 4 4 4 23 4 4 4 4 4 4 4 4 4 4 23 4 4 4 4 4 4 21 
16 1 4 4 4 4 23 4 4 4 4 4 4 4 4 4 4 4 4 4 4 4 4 4 21 
16 1 4 4 4 4 23 4 4 23 4 4 25 4 4 4 4 4 4 4 4 23 4 25 21 
16 1 4 4 23 25 23 23 4 4 4 4 4 4 25 4 4 4 4 4 4 4 4 4 21 
16 1 4 4 4 4 4 4 4 4 4 4 4 4 4 4 4 4 4 4 4 4 4 4 21 
16 1 4 4 4 4 4 4 4 4 4 4 23 4 4 4 4 23 4 4 4 4 4 4 21 
16 1 4 4 23 4 4 4 4 4 4 4 25 4 4 4 4 4 4 4 4 4 23 4 21 
16 1 4 25 4 4 4 4 4 4 4 4 4 4 4 4 4 4 4 4 4 4 4 4 21 
16 1 4 4 4 4 4 4 4 4 4 4 4 4 4 4 4 4 4 4 4 4 4 4 21 
16 1 4 23 23 4 4 4 4 4 4 4 4 4 4 4 4 4 23 25 4 4 23 4 21 
16 1 4 4 4 4 4 4 4 25 23 4 4 4 4 4 4 4 4 4 4 4 4 4 21 
16 1 4 4 4 4 4 4 4 4 4 4 4 23 4 4 4 4 4 4 4 4 4 4 21 
16 1 4 4 4 4 4 4 4 4 4 23 4 4 23 4 4 4 4 4 4 4 4 4 21 
16 2 5 5 5 5 5 5 5 5 5 5 5 5 5 5 5 5 5 5 5 5 5 5 21 
16 9 9 9 9 9 9 9 9 9 9 9 9 9 9 9 9 9 9 9 9 9 9 9 21 
17 19 19 19 19 19 19 19 19 19 19 19 19 19 19 19 19 19 19 19 19 19 19 19 22 
