15 18 18 18 18 18 18 18 18 18 18 18 18 18 18 18 18 18 18 18 18 18 18 18 20 
16 0 3 3 3 4 3 3 3 3 3 3 3 3 3 3 3 3 3 3 3 3 6 9 21 
16 1 4 4 4 4 4 4 4 4 4 4 4 4 4 4 4 4 4 4 4 4 7 9 21 
16 1 4 4 4 4 4 4 4 4 4 4 4 4 4 4 4 4 4 4 4 4 7 9 21 
16 1 4 4 4 4 4 4 4 4 4 4 4 4 4 4 4 4 4 4 4 4 7 9 21 
16 1 4 4 4 4 4 4 4 4 4 4 4 4 4 4 4 4 4 4 4 4 7 9 21 
16 1 4 4 4 4 4 4 4 4 4 4 4 4 4 4 4 4 4 4 4 4 7 9 21 
16 1 4 4 4 4 4 4 4 4 4 4 4 4 4 4 4 4 4 4 4 4 7 9 21 
16 1 4 4 4 4 4 4 4 4 4 4 4 4 4 4 4 4 4 4 4 4 7 9 21 
16 1 4 4 4 4 4 4 4 4 4 4 4 4 4 4 4 4 4 4 4 4 7 9 21 
16 1 4 4 4 4 4 4 4 4 4 4 4 4 4 4 4 4 4 4 4 4 7 9 21 
16 1 4 4 4 4 4 4 4 4 4 4 4 4 4 4 4 4 4 4 4 4 7 9 21 
16 1 4 4 4 4 4 4 4 4 4 4 4 4 4 4 4 4 4 4 4 4 7 9 21 
16 1 4 4 4 4 4 4 4 4 4 4 4 4 4 4 4 4 4 4 4 4 7 9 21 
16 4 4 4 4 4 4 4 4 4 4 4 4 4 4 4 4 4 4 4 4 4 7 9 21 
16 1 4 4 4 4 4 4 4 4 4 4 4 4 4 4 4 4 4 4 4 4 7 9 21 
16 1 4 4 4 4 4 4 4 4 4 4 4 4 4 4 4 4 4 4 4 4 7 9 21 
16 4 4 4 4 4 4 4 4 4 4 4 4 4 4 4 4 4 4 4 4 4 7 9 21 
16 1 4 4 4 4 4 4 4 4 4 4 4 4 4 4 4 4 4 4 4 4 7 9 21 
16 1 4 4 4 4 4 4 4 4 4 4 4 4 4 4 4 4 4 4 4 4 7 9 21 
16 2 5 5 5 5 5 5 5 5 5 5 5 5 5 5 5 5 5 5 5 5 8 9 21 
16 9 9 9 9 9 9 9 9 9 9 9 9 9 9 9 9 9 9 9 9 9 9 9 21 
16 9 13 9 9 9 9 9 9 9 9 9 9 9 9 9 9 9 9 9 9 9 9 9 21 
16 9 9 9 9 9 9 9 9 9 9 9 9 9 9 9 9 9 9 14 9 9 9 9 21 
17 19 19 19 19 19 19 19 19 19 19 19 19 19 19 19 19 19 19 19 19 19 19 19 22 
