15 18 18 18 18 18 18 18 18 18 18 18 18 18 18 18 18 18 18 18 18 18 18 18 20 
16 9 9 9 9 9 9 9 9 9 9 9 9 9 9 9 9 9 9 9 9 9 9 9 21 
16 9 9 9 9 9 9 9 9 9 9 9 9 9 9 9 9 9 9 9 9 9 9 9 21 
16 9 9 9 9 9 0 3 3 3 3 3 3 3 3 3 3 3 3 3 3 6 9 9 21 
16 9 9 9 9 9 1 4 4 4 4 4 4 4 4 4 25 4 4 4 4 7 9 9 21 
16 9 9 9 9 9 1 4 4 4 4 4 4 4 4 4 4 4 4 4 4 7 9 9 21 
16 9 9 9 9 9 1 4 23 4 4 4 4 4 4 4 23 4 4 4 4 7 9 9 21 
16 9 9 9 9 9 1 4 4 4 4 4 4 23 23 4 4 4 25 23 4 7 9 9 21 
16 9 9 9 9 9 1 4 4 4 4 4 4 4 4 4 4 4 4 4 23 7 9 9 21 
16 9 9 9 9 9 1 23 4 4 4 4 4 4 4 4 25 4 4 4 4 7 9 9 21 
16 9 9 9 9 9 1 4 4 4 4 23 4 4 25 4 4 4 4 4 4 7 9 9 21 
16 9 9 9 9 9 1 4 23 4 4 4 4 4 23 4 4 4 4 4 4 7 9 9 21 
16 9 9 9 9 9 1 4 4 4 4 4 4 4 4 4 4 4 4 4 4 7 9 9 21 
16 9 9 9 9 9 1 4 23 4 4 4 4 4 4 4 4 4 4 4 4 7 9 9 21 
16 9 9 9 9 9 1 4 4 4 4 4 4 4 4 4 4 4 4 4 4 7 9 9 21 
16 9 9 12 9 9 1 4 4 4 4 4 4 4 4 4 4 4 4 4 4 7 9 9 21 
16 9 9 9 9 9 1 4 23 25 4 4 4 4 4 4 4 4 23 4 4 7 9 9 21 
16 14 9 9 9 9 1 4 4 4 4 4 4 4 4 4 23 4 23 4 4 7 9 9 21 
16 9 9 9 9 9 1 23 4 4 23 4 4 23 4 4 4 4 4 4 4 7 9 9 21 
16 9 9 9 9 9 1 4 4 4 4 23 4 4 4 4 4 4 4 4 4 7 9 9 21 
16 9 9 9 9 9 1 23 4 4 4 4 4 4 23 4 4 4 4 23 4 7 9 9 21 
16 9 9 13 9 9 1 4 4 4 4 4 4 4 4 4 4 4 4 4 4 7 9 9 21 
16 9 9 9 9 9 2 5 5 5 5 5 5 5 5 5 5 4 5 5 5 8 9 9 21 
16 9 9 9 9 9 9 9 9 9 9 9 9 9 9 9 9 12 9 9 9 9 9 9 21 
17 19 19 19 19 19 19 19 19 19 19 19 19 19 19 19 19 19 19 19 19 19 19 19 22 
