25 26 26 26 26 26 26 26 26 26 26 26 26 26 26 26 26 26 26 26 26 26 26 26 27 
39 31 31 31 31 31 31 31 31 31 31 31 31 31 31 31 31 31 31 31 31 31 31 31 41 
39 31 31 31 31 31 31 31 31 31 31 31 31 31 31 31 31 31 31 31 31 31 31 31 41 
39 31 31 31 0 1 1 1 1 1 1 1 1 1 1 1 1 1 2 31 31 31 31 31 41 
39 31 31 31 14 15 15 15 15 15 15 15 15 15 15 15 15 15 16 31 31 31 34 31 41 
39 31 31 31 14 15 15 15 15 15 15 15 15 15 15 15 15 15 16 31 31 31 31 31 41 
39 31 31 31 14 15 15 15 15 15 15 15 15 15 15 15 15 15 16 31 31 31 31 31 41 
39 31 31 31 14 15 15 15 15 15 15 15 15 15 15 15 15 15 16 31 31 31 31 31 41 
39 31 31 31 14 15 15 15 15 15 15 15 15 15 15 15 15 15 16 31 31 31 31 31 41 
39 31 31 31 14 15 15 15 15 15 15 15 15 15 15 15 15 15 16 31 31 31 31 31 41 
39 31 31 31 14 15 15 15 15 15 15 15 15 15 15 15 15 15 16 31 31 31 31 31 41 
39 31 31 31 14 15 15 15 15 15 15 15 15 15 15 15 15 15 16 31 31 31 31 31 41 
39 31 31 31 14 15 15 15 15 15 15 15 15 15 15 15 15 15 16 31 31 31 31 31 41 
39 31 31 31 14 15 15 15 15 15 15 15 15 15 15 15 15 15 16 31 31 31 31 31 41 
39 31 31 31 14 15 15 15 15 15 15 15 15 15 15 15 15 15 16 31 31 31 31 31 41 
39 31 31 31 14 15 15 15 15 15 15 15 15 15 15 15 15 15 16 31 31 31 31 31 41 
39 31 31 31 14 15 15 15 15 15 15 15 15 15 15 15 15 15 16 31 31 31 31 31 41 
39 31 31 31 14 15 15 15 15 15 15 15 15 15 15 15 15 15 16 31 31 31 31 31 41 
39 31 31 31 14 15 15 15 15 15 15 15 15 15 15 15 15 15 16 31 31 31 31 31 41 
39 31 31 31 14 15 15 15 15 15 15 15 15 15 15 15 15 15 16 31 31 31 31 31 41 
39 31 31 31 14 15 15 15 15 15 15 15 15 15 15 15 15 15 16 31 31 31 31 31 41 
39 31 31 31 14 15 15 15 15 15 15 15 15 15 15 15 15 15 16 31 31 31 31 31 41 
39 31 31 31 28 29 29 15 29 29 29 29 29 29 29 29 29 15 30 31 31 31 31 31 41 
39 31 31 31 31 31 31 33 31 31 31 31 31 31 31 31 31 33 31 31 31 31 31 31 41 
53 54 54 54 54 54 54 54 54 54 54 54 54 54 54 54 54 54 54 54 54 54 54 54 55 
