25 39 39 39 39 39 39 39 39 39 39 39 39 39 39 39 39 39 39 53 
26 31 0 14 14 14 14 14 14 14 14 14 14 14 14 14 14 28 31 54 
26 31 1 15 15 6 15 15 15 15 15 15 15 15 5 15 15 29 31 54 
26 31 1 15 15 15 15 15 15 15 15 15 15 5 15 15 15 29 31 54 
26 31 1 15 15 15 15 15 5 15 15 15 15 6 15 15 5 29 31 54 
26 31 1 15 15 15 15 15 15 5 15 15 15 15 15 15 15 29 31 54 
26 31 1 15 15 15 15 15 15 15 15 15 15 15 15 15 15 29 31 54 
26 31 1 15 15 15 15 15 15 15 5 15 5 15 15 15 5 29 31 54 
26 31 1 5 15 15 5 5 15 15 15 5 15 15 15 15 15 29 31 54 
26 31 1 15 15 5 5 15 5 15 15 15 15 5 15 15 15 29 31 54 
26 31 1 15 15 15 15 5 15 15 5 15 6 15 15 15 15 29 31 54 
26 31 1 15 15 15 15 15 15 15 5 15 15 15 15 15 15 29 31 54 
26 31 1 15 15 15 15 15 15 15 15 15 15 15 15 15 15 29 31 54 
26 31 1 15 5 15 15 15 5 15 5 15 15 15 15 15 15 29 31 54 
26 31 1 15 15 6 15 15 15 15 15 15 15 15 15 15 15 29 31 54 
26 31 1 15 15 15 5 15 15 15 15 15 15 15 15 15 15 29 31 54 
26 31 1 15 15 5 15 15 15 15 15 15 15 5 15 15 15 29 31 54 
26 31 1 15 15 15 15 15 15 6 15 15 15 15 15 15 15 29 31 54 
26 31 1 15 15 5 15 15 15 5 15 15 15 15 15 15 15 29 31 54 
27 41 41 41 41 41 41 41 41 41 41 41 41 41 41 41 41 41 41 55 
