25 26 26 26 26 26 26 26 26 26 26 26 26 26 26 26 26 26 26 26 26 26 26 26 26 26 26 26 26 26 26 26 26 26 26 26 26 26 26 26 26 26 26 26 26 26 26 26 26 27 
39 31 31 31 31 31 31 31 31 31 31 31 31 31 31 31 31 31 31 31 31 31 31 31 31 31 35 31 31 36 31 31 31 31 31 31 31 31 31 31 31 31 31 31 31 31 31 31 31 41 
39 31 31 31 31 31 31 31 31 31 31 31 31 31 31 31 31 31 31 31 31 31 31 31 31 31 31 31 31 31 31 31 31 31 31 31 31 31 31 31 31 31 31 31 31 31 31 31 31 41 
39 31 31 31 31 31 31 31 31 31 31 31 31 31 31 31 31 31 31 31 31 31 31 31 31 31 31 31 31 31 31 31 31 31 31 31 31 31 31 31 31 31 31 31 31 31 31 31 31 41 
39 31 31 31 31 31 31 31 31 31 31 31 31 31 31 31 31 31 31 31 31 31 31 31 31 31 31 31 31 31 31 31 31 31 31 31 31 31 31 31 31 31 31 31 31 31 31 31 31 41 
39 31 31 31 31 31 31 31 31 31 31 31 31 31 31 31 31 31 31 31 31 31 31 31 31 31 31 31 31 31 31 31 31 31 31 31 31 31 31 31 33 31 31 31 31 31 33 31 31 41 
39 31 31 31 31 31 31 31 31 31 31 31 31 31 31 31 31 31 31 31 31 31 31 31 31 31 31 31 31 31 31 31 31 31 31 31 31 31 31 31 31 31 31 31 31 31 31 31 31 41 
39 31 31 31 31 31 31 31 33 31 31 31 31 31 31 31 31 31 31 33 31 31 35 31 31 31 31 31 31 31 31 31 31 31 31 31 31 31 31 31 31 31 31 31 31 31 31 31 31 41 
39 31 31 31 31 31 31 31 31 31 31 33 31 31 31 31 31 31 31 31 31 31 31 31 31 31 31 31 31 31 31 31 31 31 31 31 31 31 31 35 31 31 31 31 31 31 31 31 31 41 
39 31 31 31 31 31 31 31 31 31 31 31 31 31 31 31 31 31 31 31 31 31 31 33 31 31 31 34 31 31 31 31 31 31 31 31 31 31 31 31 31 31 35 31 31 31 31 31 31 41 
39 31 31 33 31 31 31 31 34 31 31 31 31 31 31 31 31 31 31 31 31 31 31 31 31 31 31 31 31 31 31 31 31 31 31 31 36 31 31 31 31 31 31 31 31 31 31 31 31 41 
39 31 31 31 31 31 31 31 31 31 31 31 31 31 31 31 31 31 31 31 31 31 31 31 31 31 31 31 31 31 31 31 31 31 31 31 31 31 31 31 31 31 31 31 31 31 31 31 31 41 
39 31 31 31 31 31 31 31 31 31 31 31 31 31 31 31 31 31 31 31 31 31 31 31 31 31 33 31 31 31 31 31 31 31 31 31 31 31 31 31 31 31 31 31 31 31 31 31 31 41 
39 31 31 31 31 31 31 31 31 31 31 31 31 31 31 31 31 31 31 31 31 31 31 31 31 31 31 31 31 31 31 31 31 31 31 31 31 31 31 31 31 31 31 31 31 31 31 35 31 41 
39 31 31 0 1 1 1 1 1 1 1 1 1 1 1 1 1 1 1 1 1 1 1 1 1 1 1 1 1 1 1 1 1 1 1 1 1 1 1 1 1 1 1 1 1 1 1 16 31 41 
39 31 31 14 15 15 6 15 15 15 15 15 15 5 15 15 15 15 15 15 15 15 15 15 15 5 15 15 15 15 15 6 15 15 5 5 15 15 15 15 15 15 15 15 15 15 15 16 31 41 
39 31 31 14 15 5 15 15 15 15 15 15 15 15 15 15 15 15 15 15 5 6 15 15 15 15 15 15 15 15 15 15 15 15 5 15 15 15 15 5 15 15 5 15 5 15 15 16 31 41 
39 31 31 14 15 15 15 15 15 15 15 15 15 15 15 15 15 15 5 15 15 5 15 15 15 15 15 15 15 15 15 15 15 15 15 15 15 15 15 5 5 15 15 15 15 15 15 16 31 41 
39 31 31 14 15 15 15 15 15 15 5 15 15 15 15 15 15 5 5 15 15 15 15 15 15 15 15 15 15 6 15 15 15 5 5 15 15 6 15 15 15 15 15 15 15 15 15 16 31 41 
39 31 31 14 15 15 15 15 15 15 5 15 15 15 15 15 15 15 15 6 15 15 15 15 5 15 15 15 5 15 15 15 15 15 15 15 15 5 15 15 15 5 15 15 15 15 15 16 31 41 
39 31 31 14 15 15 15 15 15 15 6 15 15 15 15 15 15 15 15 15 15 15 15 15 5 15 15 15 5 5 15 5 15 15 15 15 15 15 15 15 6 5 15 15 15 15 15 16 31 41 
39 31 31 14 15 15 15 15 15 15 15 15 15 15 15 15 15 5 15 5 5 5 15 5 15 15 15 15 15 15 15 15 15 5 15 15 15 15 15 15 15 15 6 15 15 15 15 16 31 41 
39 31 31 14 6 15 15 15 15 5 15 15 5 15 15 15 15 5 15 15 15 5 15 15 5 15 5 15 15 15 15 15 15 15 15 15 15 6 15 15 15 15 15 15 15 15 15 16 31 41 
39 31 31 14 15 15 15 15 15 15 15 15 15 15 6 5 5 15 15 15 15 15 15 15 15 5 15 15 5 15 5 5 15 15 6 15 15 15 15 15 15 15 15 15 15 15 15 16 31 41 
39 31 31 14 15 15 15 15 15 15 5 15 15 15 15 15 15 15 15 15 15 15 15 15 5 15 15 15 15 15 15 15 5 15 15 15 15 5 15 15 15 15 6 15 15 15 15 16 31 41 
39 31 31 14 15 15 15 15 15 15 5 15 5 15 5 15 15 15 15 15 15 5 5 15 15 15 15 15 15 15 15 5 15 15 5 15 15 15 15 15 15 15 15 15 15 15 15 16 31 41 
39 31 31 14 15 5 15 5 15 15 15 15 15 15 15 15 15 15 15 15 15 15 15 15 15 15 15 15 15 15 15 15 15 15 15 15 15 15 15 6 15 5 15 15 15 15 15 16 31 41 
39 31 31 14 15 15 15 15 15 15 15 15 15 15 15 15 15 15 15 15 15 5 15 15 15 15 15 15 15 5 15 15 15 15 15 15 15 15 15 15 15 15 15 5 15 5 5 16 31 41 
39 31 31 14 15 15 15 5 15 5 15 6 15 15 15 15 6 15 15 15 5 15 15 5 5 15 15 5 15 15 15 15 15 15 15 5 15 15 15 15 15 15 15 15 15 15 15 16 31 41 
39 31 31 14 6 15 15 15 15 15 15 15 15 15 15 15 15 15 15 15 15 15 5 5 15 5 15 5 15 15 15 15 15 15 15 15 15 15 15 15 15 15 15 5 5 15 15 16 31 41 
39 31 31 14 15 15 15 15 15 15 15 15 15 15 15 15 15 15 15 15 15 15 15 15 15 15 15 15 15 15 15 15 15 15 5 15 15 15 15 15 15 15 15 15 15 15 15 16 31 41 
39 31 31 14 15 15 15 15 15 15 15 5 15 15 5 5 15 5 15 15 5 5 15 15 15 6 15 15 15 15 15 15 15 15 15 15 15 15 15 15 15 5 15 15 15 15 15 16 31 41 
39 31 31 14 5 15 15 15 15 15 5 15 15 15 15 15 5 15 15 15 5 15 15 15 15 15 15 15 15 15 15 15 15 15 15 15 15 15 15 5 15 15 15 15 15 15 15 16 31 41 
39 31 31 28 29 29 29 29 29 29 29 29 29 29 29 29 29 29 29 29 29 29 29 29 29 29 29 29 29 29 29 29 29 29 6 29 29 29 29 29 29 29 29 29 29 29 29 30 31 41 
39 31 31 31 31 31 31 31 31 31 31 31 31 31 31 31 31 31 31 31 31 31 31 31 31 31 31 31 31 31 31 31 31 31 33 31 31 31 31 31 31 31 31 31 31 31 31 31 31 41 
39 31 31 31 31 31 31 31 31 31 31 36 31 31 31 31 31 31 31 31 31 31 31 31 31 31 31 31 31 31 31 31 31 31 31 31 31 31 31 31 31 31 31 31 31 31 31 31 31 41 
39 31 31 31 31 31 31 31 31 31 31 31 31 31 31 31 31 31 31 31 31 31 31 31 31 31 31 31 31 31 31 31 31 31 31 31 31 31 31 31 31 31 31 31 31 31 31 31 31 41 
39 31 31 31 31 31 31 31 31 31 31 31 31 31 31 31 31 31 31 31 31 33 31 31 31 31 31 31 31 31 31 31 31 31 31 31 31 31 31 31 31 31 31 31 31 31 31 31 31 41 
39 31 31 31 31 31 31 31 31 31 31 31 31 31 31 31 31 31 31 31 31 31 31 31 33 31 31 31 31 31 34 31 31 31 31 31 31 31 31 31 31 31 31 31 31 31 31 31 31 41 
39 31 31 31 31 31 31 31 31 31 31 31 31 31 31 31 31 31 31 31 31 31 31 31 31 31 31 31 31 31 31 31 31 31 31 31 31 31 31 31 31 31 31 31 31 31 31 31 31 41 
39 31 31 31 31 31 31 31 31 31 31 31 31 31 31 31 31 31 31 31 31 31 31 31 31 31 31 31 31 31 31 31 31 31 31 31 31 31 31 31 31 31 31 31 31 31 31 31 31 41 
39 31 31 31 31 31 31 31 31 31 31 31 31 31 31 31 31 31 31 31 31 31 31 31 31 31 31 31 31 31 31 31 31 31 35 31 31 31 31 31 31 31 31 31 31 31 31 31 31 41 
39 31 31 31 31 31 31 31 33 31 31 31 31 31 31 31 31 31 31 31 31 31 31 31 31 31 31 31 31 31 31 31 31 31 31 33 31 31 31 31 31 31 31 31 31 31 31 31 31 41 
39 31 31 31 31 31 31 31 31 31 31 31 31 31 31 31 31 31 31 31 31 31 31 31 31 31 31 31 31 31 31 31 31 31 31 31 31 31 31 31 31 31 31 31 31 31 31 31 31 41 
39 31 31 31 31 31 31 31 31 31 31 31 31 31 31 31 31 31 31 31 31 31 36 31 31 31 31 31 31 31 31 31 31 31 31 33 31 31 31 31 31 31 31 31 31 31 31 31 31 41 
39 31 31 31 31 31 31 31 31 31 31 31 31 31 31 31 31 31 31 31 31 31 31 31 31 31 31 31 31 31 31 31 31 31 31 31 31 31 31 31 31 31 31 31 31 31 31 31 31 41 
39 31 31 31 31 31 31 31 31 31 31 31 31 31 31 31 31 31 31 31 31 31 31 31 31 31 31 31 31 31 31 31 31 31 31 31 31 31 31 31 31 31 31 31 31 31 31 31 31 41 
39 31 31 31 31 31 31 31 31 31 31 31 31 31 31 31 31 31 31 31 31 31 31 31 31 31 31 31 31 31 31 31 31 31 31 31 31 31 36 31 31 31 31 31 31 31 31 31 31 41 
39 31 31 31 31 33 31 31 31 31 31 31 31 31 31 31 31 31 31 31 31 31 31 31 31 31 31 31 31 31 31 31 31 31 31 31 31 31 31 31 31 31 31 31 31 31 31 31 31 41 
53 54 54 54 54 54 54 54 54 54 54 54 54 54 54 54 54 54 54 54 54 54 54 54 54 54 54 54 54 54 54 54 54 54 54 54 54 54 54 54 54 54 54 54 54 54 54 54 54 55 
