31 31 31 31 31 31 31 31 31 31 31 31 31 31 31 34 31 31 31 31 31 31 31 31 31 31 31 31 31 31 31 31 31 31 31 31 31 31 31 31 31 31 31 31 31 31 31 31 31 31 
31 31 31 31 31 31 31 31 36 31 31 31 31 31 31 31 31 31 31 31 31 31 31 31 31 36 31 31 31 31 31 31 31 31 31 31 31 31 31 31 31 31 31 31 31 31 31 31 31 31 
31 31 31 31 31 31 31 31 31 31 31 31 31 31 31 31 31 31 31 31 31 31 31 31 31 31 31 31 31 31 31 31 31 31 31 31 31 31 31 33 31 31 31 31 31 31 31 31 31 31 
31 31 31 31 34 31 31 31 31 31 31 31 31 31 31 31 31 31 31 31 31 31 31 31 31 31 31 31 31 31 31 31 31 31 31 31 31 31 31 31 31 31 31 31 31 31 31 31 31 31 
31 31 31 31 31 31 31 31 31 31 31 31 31 31 0 1 1 1 1 1 1 1 1 1 1 1 1 1 1 2 31 36 31 31 31 31 31 31 31 31 31 31 31 31 31 31 31 31 31 31 
31 31 31 31 31 31 31 31 31 31 31 31 31 31 14 15 15 15 15 15 15 15 15 15 15 15 15 15 15 15 33 31 31 31 31 31 31 31 31 31 31 31 31 31 31 31 31 31 31 31 
31 31 31 31 31 31 31 31 31 31 31 31 31 31 14 15 15 15 15 15 15 15 15 15 15 15 15 15 15 16 31 31 31 31 31 31 31 31 31 31 31 31 31 31 31 31 31 31 31 31 
31 31 31 31 31 31 31 31 31 31 34 31 31 31 14 15 15 15 15 15 15 15 15 15 15 15 15 15 15 16 31 31 31 31 31 31 31 31 31 31 31 31 31 31 31 31 31 31 31 31 
31 31 31 31 31 31 31 31 31 31 31 31 31 31 14 15 15 15 15 15 15 15 15 15 15 15 15 15 15 16 31 31 31 31 34 31 31 31 31 31 31 31 31 31 31 31 31 31 31 31 
31 31 31 31 31 31 31 31 31 31 31 31 31 31 14 15 15 15 15 15 15 15 15 15 15 15 15 15 15 16 31 31 31 31 31 31 31 31 31 31 31 31 31 31 31 31 31 31 31 31 
31 31 31 31 31 31 31 31 31 31 31 31 31 31 14 15 15 15 15 15 15 15 15 15 15 15 15 15 15 16 31 31 31 31 31 31 31 31 31 31 31 31 31 31 31 31 31 31 31 31 
31 31 31 31 31 31 31 31 31 31 31 31 31 31 14 15 15 15 15 15 15 15 15 15 15 15 15 15 15 16 31 31 31 31 31 31 31 31 31 31 31 31 31 31 31 31 31 31 31 31 
31 31 31 31 31 31 31 31 31 31 31 31 31 31 14 15 15 15 15 15 15 15 15 15 15 15 15 15 15 16 31 31 31 31 31 31 31 31 31 31 31 31 31 31 31 31 31 31 31 31 
31 31 31 31 31 31 31 31 31 31 31 31 31 31 14 15 15 15 15 15 15 15 15 15 15 15 15 15 15 16 31 31 31 31 31 31 31 31 31 31 31 31 31 31 31 31 31 31 31 31 
31 31 31 31 31 31 31 31 31 31 33 31 31 34 15 15 15 15 15 15 15 15 15 15 15 15 15 15 15 16 31 31 31 31 31 31 31 31 31 31 31 31 31 31 31 31 31 31 31 31 
31 31 36 31 31 31 31 31 31 31 31 31 31 31 14 15 15 15 15 15 15 15 15 15 15 15 15 15 15 16 31 31 31 31 31 31 31 31 31 31 31 31 31 31 31 31 31 31 31 33 
31 31 31 31 31 31 31 31 31 31 31 31 31 31 14 15 15 15 15 15 15 15 15 15 15 15 15 15 15 16 31 31 31 31 31 31 31 31 31 31 31 31 31 31 31 31 31 31 31 31 
31 31 31 31 31 31 31 31 31 31 31 31 31 31 14 15 15 15 15 15 15 15 15 15 15 15 15 15 15 16 31 31 31 31 31 31 31 31 31 31 31 31 31 31 35 31 31 31 31 31 
31 31 31 31 31 31 31 31 31 31 31 31 31 31 14 15 15 15 15 15 15 15 15 15 15 15 15 15 15 16 31 31 31 31 31 31 31 31 31 35 31 31 31 31 31 31 31 31 31 31 
31 31 31 31 31 31 31 31 31 31 31 36 31 31 14 15 15 15 15 15 15 15 15 15 15 15 15 15 15 16 31 31 31 31 31 31 31 31 31 31 31 31 31 31 31 31 31 31 31 31 
31 31 31 33 31 31 31 31 31 31 31 31 31 31 14 15 15 15 15 15 15 15 15 15 15 15 15 15 15 16 31 31 31 31 31 31 31 31 31 31 31 31 31 31 31 31 31 31 31 35 
31 34 31 31 31 31 31 31 31 31 31 31 31 31 14 15 15 15 15 15 15 15 15 15 15 15 15 15 15 16 31 31 31 35 31 31 31 31 31 31 31 31 33 31 31 31 31 31 31 31 
31 31 31 31 31 31 31 31 31 34 31 31 31 31 14 15 15 15 15 15 15 15 15 15 15 15 15 15 15 16 31 31 31 31 31 31 31 31 31 31 31 31 31 31 31 31 31 33 31 31 
31 31 31 31 31 31 31 31 31 31 31 31 31 31 14 15 15 15 15 15 15 15 15 15 15 15 15 15 15 16 31 31 31 31 31 31 31 31 31 31 31 31 31 31 31 31 31 31 31 31 
31 31 31 31 31 31 31 31 31 31 31 31 31 31 14 15 15 15 15 15 15 15 15 15 15 15 15 15 15 16 31 31 31 31 31 31 31 31 31 31 31 31 31 31 31 31 31 31 31 31 
31 31 31 31 31 31 31 31 31 31 31 31 31 31 14 15 15 15 15 15 15 15 15 15 15 15 15 15 15 16 31 31 31 31 31 31 31 31 31 31 31 31 31 31 31 31 31 31 31 31 
31 31 31 31 31 31 31 31 31 31 31 31 31 31 14 15 15 15 15 15 15 15 15 15 15 15 15 15 15 16 31 31 31 31 31 31 31 31 31 31 31 31 31 31 31 31 31 31 31 31 
31 31 31 31 31 31 31 31 31 31 31 31 31 31 14 15 15 15 15 15 15 15 15 15 15 15 15 15 15 16 31 31 31 31 31 31 31 31 31 31 31 31 31 31 31 31 31 31 31 31 
31 31 31 31 31 31 31 31 31 31 31 31 31 31 14 15 15 15 15 15 15 15 15 15 15 15 15 15 15 16 31 31 31 31 31 31 31 31 31 31 31 31 31 31 31 31 31 31 31 31 
31 31 31 31 31 34 31 31 31 31 31 31 31 31 14 15 15 15 15 15 15 15 15 15 15 15 15 15 15 16 31 31 31 31 31 31 31 31 31 31 31 31 31 31 31 31 31 31 31 31 
31 31 31 31 31 31 31 31 31 31 31 31 31 31 14 15 15 15 15 15 15 15 15 15 15 15 15 15 15 16 31 31 33 31 31 31 31 31 31 31 31 31 31 31 31 31 31 31 31 31 
31 31 31 31 31 31 31 31 31 31 31 31 31 31 14 15 15 15 15 15 15 15 15 15 15 15 15 15 15 16 31 31 31 31 31 31 31 31 31 31 31 31 31 31 31 31 31 31 31 31 
31 31 31 31 31 31 31 31 31 31 31 31 31 31 14 15 15 15 15 15 15 15 15 15 15 15 15 15 15 16 31 31 36 31 31 31 31 31 33 31 31 31 31 31 31 31 31 31 31 31 
31 31 35 31 31 31 31 31 31 31 31 31 31 31 14 15 15 15 15 15 15 15 15 15 15 15 15 15 15 16 31 31 31 31 31 31 31 31 31 31 31 31 31 31 31 31 31 31 31 31 
31 31 31 31 31 31 31 31 31 31 31 31 31 31 14 15 15 15 15 15 15 15 15 15 15 15 15 15 15 16 31 31 31 31 35 31 31 31 31 31 31 31 31 31 31 31 31 31 31 31 
31 31 31 31 31 31 31 31 31 31 31 31 31 31 14 15 15 15 15 15 15 15 15 15 15 15 15 15 15 16 31 31 31 31 31 31 31 31 31 31 31 31 31 31 31 31 31 31 31 31 
36 31 31 31 31 31 31 31 31 31 31 31 31 31 14 15 15 15 15 15 15 15 15 15 15 15 15 15 15 16 31 31 31 31 31 31 31 31 35 31 31 31 31 31 31 31 31 31 31 31 
31 31 31 31 31 31 31 31 31 31 31 31 31 31 14 15 15 15 15 15 15 15 15 15 15 15 15 15 15 16 31 31 31 31 31 31 31 31 31 31 31 31 31 31 31 31 31 31 31 31 
31 31 31 31 31 31 31 31 31 31 31 33 31 31 14 15 15 15 15 15 15 15 15 15 15 15 15 15 15 16 31 31 31 31 31 31 31 31 31 31 31 31 31 31 31 31 31 31 31 31 
31 31 31 31 31 31 31 31 31 31 31 31 31 31 14 15 15 15 15 15 15 15 15 15 15 15 15 15 15 16 31 31 31 31 31 31 31 31 31 31 31 31 31 31 31 31 31 31 31 31 
31 31 31 31 31 31 31 31 31 31 31 31 31 31 14 15 15 15 15 15 15 15 15 15 15 15 15 15 15 16 31 31 31 31 31 31 31 31 31 31 31 31 31 31 31 31 31 31 31 31 
31 34 31 31 31 31 31 31 31 31 31 31 31 31 14 15 15 15 15 15 15 15 15 15 15 15 15 15 15 16 31 31 31 31 31 31 31 31 31 31 31 31 31 31 31 31 31 36 31 31 
31 33 31 31 31 31 31 31 31 31 31 31 31 31 14 15 15 15 15 15 15 15 15 15 15 15 15 15 15 16 31 31 36 31 31 31 31 31 31 31 31 31 31 31 31 31 31 31 31 31 
31 31 31 31 31 31 31 31 31 31 31 31 31 31 14 15 15 15 15 15 15 15 15 15 15 15 15 15 15 16 31 31 31 31 31 31 31 31 31 31 31 31 31 31 31 31 31 31 31 31 
31 31 31 31 31 35 31 31 31 31 31 31 31 31 28 29 29 29 29 29 29 29 29 29 29 29 29 29 29 30 31 31 31 31 31 31 33 34 31 31 31 31 31 31 31 31 31 31 31 31 
31 31 31 31 31 31 31 31 31 31 31 31 31 31 31 31 31 31 31 31 31 31 31 31 31 31 31 31 31 31 31 31 31 31 31 31 31 31 31 31 31 31 31 31 31 31 31 31 31 31 
31 31 36 31 31 31 31 31 31 31 31 31 31 31 31 31 31 31 31 31 31 31 31 34 31 31 31 31 31 31 31 31 31 31 31 31 31 31 31 31 31 31 31 31 31 31 31 31 31 31 
31 31 31 31 31 31 31 31 31 31 31 31 31 31 31 31 31 31 34 31 31 31 31 31 31 31 31 31 31 31 31 31 31 31 31 31 31 31 31 31 31 31 31 31 31 31 31 31 31 31 
31 31 31 31 31 31 31 31 31 31 31 31 31 31 31 31 31 31 31 31 31 31 31 31 31 31 31 31 31 31 31 31 31 31 31 31 31 31 31 31 31 31 31 31 31 31 31 31 31 31 
31 31 31 31 31 31 31 31 31 31 31 31 31 31 31 31 31 31 31 31 31 31 31 31 31 31 31 31 31 31 31 31 31 31 31 31 31 31 31 31 31 31 31 31 31 35 31 31 33 31 
