25 39 39 39 39 39 39 39 39 39 39 39 39 39 39 39 39 39 39 53 
26 0 14 14 14 14 14 14 14 14 14 14 14 14 14 14 14 14 28 54 
26 1 5 15 15 5 5 15 6 15 15 15 15 15 15 15 15 15 5 54 
26 1 15 15 15 15 5 15 15 15 5 15 15 15 15 15 5 15 29 54 
26 1 15 15 15 15 15 15 5 15 15 15 15 15 15 15 15 15 29 54 
26 1 15 15 15 15 15 15 15 15 15 15 15 15 15 15 15 15 29 54 
26 1 6 15 5 15 15 15 15 15 15 15 15 15 15 15 15 15 29 54 
26 1 15 15 15 15 15 5 15 15 15 15 15 15 5 15 15 15 29 54 
26 1 15 15 5 15 15 15 15 15 15 15 15 15 15 15 15 15 29 54 
26 1 15 15 15 15 15 15 15 15 15 15 15 15 15 15 15 15 29 54 
26 1 15 15 15 15 15 15 15 15 15 15 6 6 15 15 5 15 29 54 
26 1 15 5 15 15 15 15 15 15 15 15 15 15 15 15 15 15 29 54 
26 1 6 15 15 15 15 5 15 5 15 15 15 15 15 15 15 15 29 54 
26 1 15 15 15 15 15 15 15 6 15 15 15 15 15 15 15 15 29 54 
26 1 15 15 15 15 5 15 15 15 15 15 15 15 15 15 15 15 29 54 
26 1 5 15 15 15 5 15 5 15 6 15 15 15 15 15 15 15 29 54 
26 1 15 5 15 15 15 15 6 15 15 5 15 15 15 15 15 15 29 54 
26 1 15 15 15 15 15 15 15 15 5 15 5 15 15 15 15 15 29 54 
26 1 15 5 15 15 15 15 6 15 15 15 15 5 6 15 15 15 29 54 
27 41 41 41 41 41 41 41 41 41 41 41 41 41 41 41 41 41 41 55 
