110 110 110 110 110 110 110 110 110 110 110 110 110 110 110 110 110 110 110 110 110 110 110 110 110 110 110 110 110 110 110 110 110 110 110 110 110 110 110 110 110 110 110 110 110 110 110 110 110 110 
110 110 110 110 110 110 110 110 110 110 110 110 110 110 110 110 110 110 110 110 110 110 110 110 110 110 110 110 110 110 110 110 110 110 110 110 110 110 110 110 110 110 110 110 110 110 110 110 110 110 
110 110 110 110 110 110 110 110 110 110 110 110 110 110 110 110 110 110 110 110 110 110 110 110 110 110 110 110 110 110 110 110 110 110 110 110 110 110 110 110 110 110 110 110 110 110 110 110 110 110 
110 110 110 110 110 110 110 110 110 110 110 110 110 110 110 110 110 110 110 110 110 110 110 110 110 110 110 110 110 110 110 110 110 110 110 110 110 110 110 110 110 110 110 110 110 110 110 110 110 110 
110 110 110 110 110 110 110 110 110 110 110 110 110 110 110 110 110 110 110 110 110 110 110 110 110 110 110 110 110 110 110 110 110 110 110 110 110 110 110 110 110 110 110 110 110 110 110 110 110 110 
110 110 110 110 110 110 110 110 110 110 110 110 110 110 110 110 110 110 110 110 110 110 110 110 110 110 110 110 110 110 110 110 110 110 110 110 110 110 110 110 110 110 110 110 110 110 110 110 110 110 
110 110 110 110 110 110 110 110 110 110 110 110 110 110 110 110 110 110 110 110 110 110 110 110 110 110 110 110 110 110 110 110 110 110 110 110 110 110 110 110 110 110 110 110 110 110 110 110 110 110 
110 110 110 110 110 110 110 110 110 110 110 110 110 110 110 110 110 110 110 110 110 110 110 110 110 110 110 110 110 110 110 110 110 110 110 110 110 110 110 110 110 110 110 110 110 110 110 110 110 110 
110 110 110 110 110 110 110 110 110 110 110 110 110 200 203 203 203 203 203 203 203 203 203 203 200 110 110 110 110 110 110 110 110 110 110 110 110 110 110 110 110 110 110 110 110 110 110 110 110 110 
110 110 110 110 110 110 110 110 110 110 110 110 110 201 6 6 6 6 6 6 6 6 6 6 212 110 110 110 110 110 110 110 110 110 110 110 110 110 110 110 110 110 110 110 110 110 110 110 110 110 
110 110 110 110 110 110 110 110 110 110 110 110 110 201 26 6 6 0 1 2 26 26 46 26 202 203 203 203 203 203 203 203 203 203 203 203 203 203 203 203 200 110 110 110 110 110 110 110 110 110 
110 110 110 110 110 110 110 110 110 110 110 110 110 201 26 53 6 14 26 23 2 26 26 26 26 134 134 134 134 134 134 134 134 134 26 26 26 26 134 134 212 110 110 110 110 110 110 110 110 110 
110 110 110 110 110 110 110 110 110 110 110 110 110 201 6 6 6 28 29 30 14 26 26 26 26 26 26 26 26 26 26 26 26 26 47 26 26 53 26 26 212 110 110 110 110 110 110 110 110 110 
110 110 110 110 110 110 110 110 110 110 110 110 110 201 6 6 6 26 45 26 14 26 26 26 51 26 26 26 67 68 69 26 26 26 26 26 48 26 6 26 212 110 110 110 110 110 110 110 110 110 
110 110 110 110 110 110 110 110 110 110 110 110 110 201 6 6 6 6 6 26 14 26 26 26 26 26 26 26 26 26 26 53 26 26 95 210 97 6 6 6 212 110 110 110 110 110 110 110 110 110 
110 110 110 110 110 110 110 110 110 110 110 110 110 201 6 6 6 6 6 26 14 26 26 26 26 26 26 26 26 26 26 26 26 26 212 110 201 6 6 6 212 110 110 110 110 110 110 110 110 110 
110 110 110 110 110 110 110 110 110 110 110 110 110 206 210 210 210 210 211 26 14 26 26 26 152 153 154 155 156 157 158 26 26 26 123 124 125 6 6 6 212 110 110 110 110 110 110 110 110 110 
110 110 110 110 110 110 110 110 110 110 110 110 110 110 110 110 110 110 201 26 14 26 26 26 163 164 165 166 167 168 169 26 26 26 26 7 26 6 6 6 212 110 110 110 110 110 110 110 110 110 
110 110 110 110 110 110 110 110 110 110 110 110 110 110 110 110 110 110 201 26 14 26 26 26 26 14 14 14 26 14 26 26 26 26 26 14 26 26 26 26 212 110 110 110 110 110 110 110 110 110 
110 110 110 110 110 110 110 110 110 110 110 110 110 110 200 203 203 203 204 26 23 29 29 29 29 38 38 38 29 38 29 29 29 29 29 30 26 26 26 26 212 110 110 110 110 110 110 110 110 110 
110 110 110 110 110 110 110 110 110 110 110 110 110 110 201 6 6 6 6 0 30 26 26 26 26 26 26 26 26 26 26 26 26 26 26 26 26 52 26 26 212 110 110 110 110 110 110 110 110 110 
110 110 110 110 110 110 110 110 110 110 110 110 110 110 201 6 6 6 6 14 6 209 210 210 210 210 210 210 210 210 210 210 210 210 210 211 134 134 51 26 212 110 110 110 110 110 110 110 110 110 
110 110 110 110 110 110 110 110 110 110 110 110 110 110 201 6 6 6 6 14 6 212 110 110 110 110 110 110 110 110 110 110 110 110 110 201 26 26 26 26 212 110 110 110 110 110 110 110 110 110 
110 110 110 110 110 110 110 110 110 110 110 110 110 203 204 6 0 29 29 30 6 212 110 110 110 110 110 110 110 110 110 110 110 110 203 204 26 26 26 26 212 110 110 110 110 110 110 110 110 110 
110 110 110 110 110 110 110 110 110 110 110 110 201 6 6 6 14 67 68 69 6 212 110 110 110 110 110 110 110 110 203 203 203 204 26 26 26 26 26 26 212 110 110 110 110 110 110 110 110 110 
110 110 110 110 110 110 110 110 110 110 110 110 201 6 122 122 14 81 82 83 6 202 203 203 203 203 203 203 203 204 26 26 26 26 26 26 26 43 26 26 212 110 110 110 110 110 110 110 110 110 
110 110 110 110 110 110 110 110 110 110 110 110 201 6 0 29 30 6 6 6 6 6 6 6 26 26 26 26 26 26 26 26 45 26 26 26 26 53 26 26 212 110 110 110 110 110 110 110 110 110 
110 110 110 110 110 110 110 110 110 110 110 110 201 6 14 6 6 6 6 6 6 6 6 6 26 26 26 26 26 50 26 26 26 26 26 26 26 26 135 135 212 110 110 110 110 110 110 110 110 110 
110 110 110 110 110 110 110 110 110 110 110 110 201 6 14 15 126 127 128 129 15 15 26 26 26 26 26 26 26 26 26 26 26 26 26 26 26 135 135 135 212 110 110 110 110 110 110 110 110 110 
110 110 110 110 110 110 110 110 110 110 110 110 201 6 14 15 137 138 139 140 15 15 26 118 119 26 26 26 26 26 26 26 26 26 26 135 135 135 135 135 212 110 110 110 110 110 110 110 110 110 
110 110 110 110 110 110 110 110 110 110 110 110 201 6 14 26 148 149 150 151 15 52 26 132 133 26 26 209 210 210 210 210 210 210 210 210 210 210 210 210 205 110 110 110 110 110 110 110 110 110 
110 110 110 110 110 110 110 110 110 110 110 110 201 15 14 15 171 172 173 174 15 15 26 26 26 26 26 212 110 110 110 110 110 110 110 110 110 110 110 110 110 110 110 110 110 110 110 110 110 110 
110 110 110 110 110 110 110 110 110 110 110 110 201 15 28 29 29 25 14 185 15 15 209 210 210 210 210 205 110 110 110 110 110 110 110 110 110 110 110 110 110 110 110 110 110 110 110 110 110 110 
110 110 110 110 110 110 110 110 110 110 110 110 201 15 15 15 15 23 25 15 15 15 212 110 110 110 110 110 110 110 110 110 110 110 110 110 110 110 110 110 110 110 110 110 110 110 110 110 110 110 
110 110 110 110 110 110 110 110 110 110 110 110 206 210 210 211 6 23 25 6 209 210 205 110 110 110 110 110 110 110 110 110 110 110 110 110 110 110 110 110 110 110 110 110 110 110 110 110 110 110 
110 110 110 110 110 110 110 110 110 110 110 110 110 110 110 201 6 23 25 47 212 110 110 110 110 110 110 110 110 110 110 110 110 110 110 110 110 110 110 110 110 110 110 110 110 110 110 110 110 110 
110 110 110 110 110 110 110 110 110 110 110 110 110 110 110 201 45 23 25 6 212 110 110 110 110 110 110 110 110 110 110 110 110 110 110 110 110 110 110 110 110 110 110 110 110 110 110 110 110 110 
110 110 110 110 110 110 110 110 110 110 110 110 110 110 110 201 6 23 25 6 212 110 110 110 110 110 110 110 110 110 110 110 110 110 110 110 110 110 110 110 110 110 110 110 110 110 110 110 110 110 
110 110 110 110 110 110 110 110 110 110 110 110 110 110 110 206 210 96 96 210 205 110 110 110 110 110 110 110 110 110 110 110 110 110 110 110 110 110 110 110 110 110 110 110 110 110 110 110 110 110 
110 110 110 110 110 110 110 110 110 110 110 110 110 110 110 110 110 110 110 110 110 110 110 110 110 110 110 110 110 110 110 110 110 110 110 110 110 110 110 110 110 110 110 110 110 110 110 110 110 110 
110 110 110 110 110 110 110 110 110 110 110 110 110 110 110 110 110 110 110 110 110 110 110 110 110 110 110 110 110 110 110 110 110 110 110 110 110 110 110 110 110 110 110 110 110 110 110 110 110 110 
110 110 110 110 110 110 110 110 110 110 110 110 110 110 110 110 110 110 110 110 110 110 110 110 110 110 110 110 110 110 110 110 110 110 110 110 110 110 110 110 110 110 110 110 110 110 110 110 110 110 
110 110 110 110 110 110 110 110 110 110 110 110 110 110 110 110 110 110 110 110 110 110 110 110 110 110 110 110 110 110 110 110 110 110 110 110 110 110 110 110 110 110 110 110 110 110 110 110 110 110 
110 110 110 110 110 110 110 110 110 110 110 110 110 110 110 110 110 110 110 110 110 110 110 110 110 110 110 110 110 110 110 110 110 110 110 110 110 110 110 110 110 110 110 110 110 110 110 110 110 110 
110 110 110 110 110 110 110 110 110 110 110 110 110 110 110 110 110 110 110 110 110 110 110 110 110 110 110 110 110 110 110 110 110 110 110 110 110 110 110 110 110 110 110 110 110 110 110 110 110 110 
110 110 110 110 110 110 110 110 110 110 110 110 110 110 110 110 110 110 110 110 110 110 110 110 110 110 110 110 110 110 110 110 110 110 110 110 110 110 110 110 110 110 110 110 110 110 110 110 110 110 
110 110 110 110 110 110 110 110 110 110 110 110 110 110 110 110 110 110 110 110 110 110 110 110 110 110 110 110 110 110 110 110 110 110 110 110 110 110 110 110 110 110 110 110 110 110 110 110 110 110 
110 110 110 110 110 110 110 110 110 110 110 110 110 110 110 110 110 110 110 110 110 110 110 110 110 110 110 110 110 110 110 110 110 110 110 110 110 110 110 110 110 110 110 110 110 110 110 110 110 110 
110 110 110 110 110 110 110 110 110 110 110 110 110 110 110 110 110 110 110 110 110 110 110 110 110 110 110 110 110 110 110 110 110 110 110 110 110 110 110 110 110 110 110 110 110 110 110 110 110 110 
110 110 110 110 110 110 110 110 110 110 110 110 110 110 110 110 110 110 110 110 110 110 110 110 110 110 110 110 110 110 110 110 110 110 110 110 110 110 110 110 110 110 110 110 110 110 110 110 110 110 
