228 229 229 229 229 229 229 229 229 229 229 229 229 229 229 229 229 229 229 229 229 229 229 229 229 229 229 229 229 229 229 229 229 229 229 229 229 229 229 229 229 229 229 229 229 229 229 229 229 230 
231 254 254 254 254 254 254 254 254 254 254 254 254 254 254 254 254 254 254 254 254 254 254 254 254 254 254 254 254 254 254 254 254 254 254 254 254 254 254 254 254 254 254 254 254 254 254 254 254 232 
231 254 254 254 254 254 254 254 254 254 254 254 254 254 254 254 254 254 254 254 254 254 254 254 254 254 254 254 254 254 254 254 254 254 254 254 254 254 254 254 254 254 254 254 254 254 254 254 254 232 
231 254 254 254 254 254 254 254 254 254 254 254 254 254 254 254 254 254 254 254 254 254 254 254 254 254 254 254 254 254 254 254 254 254 254 254 254 254 254 254 254 254 254 254 254 254 254 254 254 232 
231 254 254 254 254 254 254 254 254 254 254 254 254 254 254 254 254 254 254 254 254 254 254 254 254 254 254 254 254 254 254 254 254 254 254 254 254 254 254 254 254 254 254 254 254 254 254 254 254 232 
231 254 254 254 254 254 254 254 254 254 254 254 254 254 254 254 254 254 254 254 254 254 254 254 254 254 254 254 254 254 254 254 254 254 254 254 254 254 254 254 254 254 254 254 254 254 254 254 254 232 
231 254 254 254 254 254 254 247 247 247 247 247 247 247 247 247 247 247 247 247 247 247 247 247 247 247 247 247 247 247 247 247 247 247 247 247 247 247 247 247 247 247 247 254 254 254 254 254 254 232 
231 254 254 254 254 254 254 247 252 251 247 247 247 247 247 247 247 247 247 247 247 247 247 247 247 247 247 247 247 247 247 247 247 247 247 247 247 247 247 247 247 247 247 254 254 254 254 254 254 232 
231 254 254 254 254 254 254 247 251 251 247 247 247 247 247 251 251 251 251 251 251 247 247 247 247 247 247 247 247 247 247 251 251 251 251 251 251 247 247 247 247 247 247 254 254 254 254 254 254 232 
231 254 254 254 254 254 254 247 247 251 247 247 247 247 251 251 251 251 251 251 251 251 247 247 247 247 247 247 247 247 251 251 251 251 247 247 251 247 247 247 247 247 247 254 254 254 254 254 254 232 
231 254 254 254 254 254 254 247 247 251 251 251 251 251 251 251 251 251 251 251 251 251 247 247 247 247 251 251 251 251 251 251 251 247 247 247 251 251 247 247 247 247 247 254 254 254 254 254 254 232 
231 254 254 254 254 254 254 247 247 247 247 247 247 247 251 251 251 251 251 251 251 251 247 247 247 251 251 251 251 251 251 251 247 247 247 247 247 251 247 247 247 247 247 254 254 254 254 254 254 232 
231 254 254 254 254 254 254 247 247 247 247 247 247 247 247 251 251 251 251 251 251 247 247 247 251 251 251 251 251 251 247 247 247 247 247 247 247 251 251 247 247 247 247 254 254 254 254 254 254 232 
231 254 254 254 254 254 254 247 247 247 247 247 247 247 247 247 247 247 251 247 247 247 247 251 251 251 251 247 247 247 247 247 247 247 247 247 251 251 251 251 247 247 247 254 254 254 254 254 254 232 
231 254 254 254 254 254 254 247 247 247 247 247 247 247 247 247 247 247 251 247 247 247 251 251 251 247 247 247 247 247 247 247 247 247 247 251 251 251 251 251 247 247 247 254 254 254 254 254 254 232 
231 254 254 254 254 254 254 247 247 247 247 247 247 247 247 251 251 251 251 251 247 247 251 251 251 247 247 251 247 247 247 247 247 247 247 251 251 251 251 251 251 247 247 254 254 254 254 254 254 232 
231 254 254 254 254 254 254 247 247 247 247 247 247 251 251 251 247 251 251 251 247 247 251 247 247 247 247 251 247 247 247 247 247 247 251 251 251 251 251 251 251 247 247 254 254 254 254 254 254 232 
231 254 254 254 254 254 254 247 251 251 247 247 247 247 247 247 247 247 251 247 247 247 251 247 247 251 251 251 251 251 247 247 251 251 251 247 247 251 251 251 247 247 247 254 254 254 254 254 254 232 
231 254 254 254 254 254 254 247 251 251 251 251 251 247 247 247 247 247 251 247 247 247 251 247 247 251 251 251 251 251 247 251 251 247 247 247 247 247 251 247 247 247 247 254 254 254 254 254 254 232 
231 254 254 254 254 254 254 247 251 251 251 251 251 247 247 247 247 247 251 247 247 247 251 247 247 251 251 251 251 251 251 251 247 247 247 247 247 247 251 247 247 247 247 254 254 254 254 254 254 232 
231 254 254 254 254 254 254 247 251 251 251 251 251 247 247 247 247 247 251 247 247 247 251 247 247 247 251 251 251 251 247 247 247 247 247 247 247 247 251 247 247 247 247 254 254 254 254 254 254 232 
231 254 254 254 254 254 254 247 251 251 251 251 251 247 247 247 247 247 251 247 247 247 251 251 247 247 247 247 247 247 247 247 247 247 247 247 247 247 251 247 247 247 247 254 254 254 254 254 254 232 
231 254 254 254 254 254 254 247 247 247 251 247 247 247 247 247 247 247 251 247 251 251 251 251 247 247 247 247 247 247 247 247 247 247 247 247 247 247 251 247 247 247 247 254 254 254 254 254 254 232 
231 254 254 254 254 254 254 247 247 247 251 247 247 247 247 247 247 247 251 247 247 247 247 247 247 247 247 247 247 247 247 247 247 247 247 247 247 251 251 251 251 247 247 254 254 254 254 254 254 232 
231 254 254 254 254 254 254 247 247 247 251 247 247 247 251 251 251 251 251 251 251 251 247 247 247 247 247 247 247 247 247 247 247 247 251 251 251 251 251 251 251 247 247 254 254 254 254 254 254 232 
231 254 254 254 254 254 254 247 247 247 251 251 251 251 251 251 251 251 251 251 251 251 251 247 247 247 247 247 247 247 247 247 251 251 251 251 251 251 251 251 251 247 247 254 254 254 254 254 254 232 
231 254 254 254 254 254 254 247 247 247 251 251 251 251 251 251 251 251 251 251 251 251 251 247 247 247 247 247 247 247 247 247 251 251 251 251 251 251 251 251 251 247 247 254 254 254 254 254 254 232 
231 254 254 254 254 254 254 247 247 247 251 251 251 251 251 251 251 251 251 251 251 251 251 247 247 247 247 247 247 247 247 247 251 251 251 251 251 251 251 251 251 247 247 254 254 254 254 254 254 232 
231 254 254 254 254 254 254 247 247 247 247 247 247 247 251 251 251 251 251 251 251 251 251 251 251 251 251 251 251 251 251 251 251 251 251 251 251 247 247 251 251 247 247 254 254 254 254 254 254 232 
231 254 254 254 254 254 254 247 247 247 247 247 247 247 247 247 247 251 251 247 247 247 247 247 247 247 251 247 247 247 247 247 251 251 251 247 247 247 247 251 251 247 247 254 254 254 254 254 254 232 
231 254 254 254 254 254 254 247 247 247 247 247 247 247 247 247 247 251 251 247 247 247 247 247 247 247 251 247 247 247 247 247 247 247 247 247 247 247 251 251 251 247 247 254 254 254 254 254 254 232 
231 254 254 254 254 254 254 247 247 247 247 247 247 247 247 247 247 251 251 247 247 247 247 247 247 247 251 247 247 247 247 247 247 247 247 247 247 247 247 251 251 247 247 254 254 254 254 254 254 232 
231 254 254 254 254 254 254 247 247 247 247 247 247 247 247 247 247 251 251 247 247 247 247 247 247 247 251 247 247 247 247 247 247 247 247 247 247 247 247 247 247 247 247 254 254 254 254 254 254 232 
231 254 254 254 254 254 254 247 247 247 247 247 247 247 247 247 247 251 251 247 247 247 247 247 247 251 251 251 247 247 247 247 247 247 247 247 247 247 247 247 247 247 247 254 254 254 254 254 254 232 
231 254 254 254 254 254 254 247 247 247 247 247 247 247 247 247 247 251 251 247 247 247 247 247 247 251 251 251 247 247 247 247 247 247 247 247 247 247 247 247 247 247 247 254 254 254 254 254 254 232 
231 254 254 254 254 254 254 247 247 247 247 247 247 247 247 251 251 251 251 251 251 247 247 247 247 247 247 247 247 247 247 247 247 247 247 247 247 247 247 247 247 247 247 254 254 254 254 254 254 232 
231 254 254 254 254 254 254 247 247 247 247 247 247 247 247 251 251 251 251 251 251 247 247 247 247 247 247 247 247 247 247 247 247 247 247 247 247 247 247 247 247 247 247 254 254 254 254 254 254 232 
231 254 254 254 254 254 254 247 247 251 251 251 251 251 251 251 251 251 251 251 251 247 247 247 247 247 247 247 247 247 247 247 247 247 247 247 251 251 251 251 251 247 247 254 254 254 254 254 254 232 
231 254 254 254 254 254 254 247 247 251 247 247 247 247 247 251 251 251 251 251 251 247 247 247 247 247 247 247 247 247 247 247 251 251 251 251 251 251 247 247 251 247 247 254 254 254 254 254 254 232 
231 254 254 254 254 254 254 247 247 251 247 247 247 247 247 251 251 251 251 251 251 247 247 247 247 247 247 247 247 247 247 251 251 251 251 251 251 247 247 247 251 247 247 254 254 254 254 254 254 232 
231 254 254 254 254 254 254 247 251 251 251 247 247 247 247 251 251 251 251 251 251 251 251 251 251 251 251 251 251 251 251 251 251 251 251 251 251 247 247 247 251 247 247 254 254 254 254 254 254 232 
231 254 254 254 254 254 254 247 251 253 251 247 247 247 247 247 247 247 247 247 247 247 247 247 247 247 247 247 247 247 247 247 251 251 251 251 251 247 247 247 251 247 247 254 254 254 254 254 254 232 
231 254 254 254 254 254 254 247 251 251 251 247 247 247 247 247 247 247 247 247 247 247 247 247 247 247 247 247 247 247 247 247 247 247 247 247 247 247 247 247 247 247 247 254 254 254 254 254 254 232 
231 254 254 254 254 254 254 247 247 247 247 247 247 247 247 247 247 247 247 247 247 247 247 247 247 247 247 247 247 247 247 247 247 247 247 247 247 247 247 247 247 247 247 254 254 254 254 254 254 232 
231 254 254 254 254 254 254 254 254 254 254 254 254 254 254 254 254 254 254 254 254 254 254 254 254 254 254 254 254 254 254 254 254 254 254 254 254 254 254 254 254 254 254 254 254 254 254 254 254 232 
231 254 254 254 254 254 254 254 254 254 254 254 254 254 254 254 254 254 254 254 254 254 254 254 254 254 254 254 254 254 254 254 254 254 254 254 254 254 254 254 254 254 254 254 254 254 254 254 254 232 
231 254 254 254 254 254 254 254 254 254 254 254 254 254 254 254 254 254 254 254 254 254 254 254 254 254 254 254 254 254 254 254 254 254 254 254 254 254 254 254 254 254 254 254 254 254 254 254 254 232 
231 254 254 254 254 254 254 254 254 254 254 254 254 254 254 254 254 254 254 254 254 254 254 254 254 254 254 254 254 254 254 254 254 254 254 254 254 254 254 254 254 254 254 254 254 254 254 254 254 232 
231 254 254 254 254 254 254 254 254 254 254 254 254 254 254 254 254 254 254 254 254 254 254 254 254 254 254 254 254 254 254 254 254 254 254 254 254 254 254 254 254 254 254 254 254 254 254 254 254 232 
233 234 234 234 234 234 234 234 234 234 234 234 234 234 234 234 234 234 234 234 234 234 234 234 234 234 234 234 234 234 234 234 234 234 234 234 234 234 234 234 234 234 234 234 234 234 234 234 234 235 
