228 229 229 229 229 229 229 229 229 229 229 229 229 229 229 229 229 229 229 229 229 229 229 229 229 229 229 229 229 229 229 229 229 229 229 229 229 229 229 229 229 229 229 229 229 229 229 229 229 230 
231 222 222 222 222 222 222 222 222 222 222 222 222 222 222 222 222 222 222 222 222 222 222 222 222 222 222 222 222 222 222 222 222 222 222 222 222 222 222 222 222 222 222 222 222 222 222 222 222 232 
231 222 222 222 222 222 222 222 222 222 222 222 222 222 222 222 222 222 222 222 222 222 222 222 222 222 222 222 222 222 222 222 222 222 222 222 222 222 222 222 222 222 222 222 222 222 222 222 222 232 
231 222 222 222 222 222 222 222 222 222 222 222 222 222 222 222 222 222 222 222 222 222 222 222 222 222 222 222 222 222 222 222 222 222 222 222 222 222 222 222 222 222 222 222 222 222 222 222 222 232 
231 222 222 222 222 222 222 222 222 222 222 222 222 222 222 222 222 222 222 222 222 222 222 222 222 222 222 222 222 222 222 222 222 222 222 222 222 222 222 222 222 222 222 222 222 222 222 222 222 232 
231 222 222 222 222 222 222 222 222 222 222 222 222 222 222 222 222 222 222 222 222 222 222 222 222 222 222 222 222 222 222 222 222 222 223 224 225 226 227 227 222 222 222 222 222 222 222 222 222 232 
231 222 222 222 222 222 222 222 222 222 222 222 222 222 222 222 222 222 222 222 222 222 222 222 222 222 222 222 222 222 222 222 222 222 222 222 222 222 222 222 222 222 222 222 222 222 222 222 222 232 
231 222 222 222 222 222 222 222 222 222 222 222 222 222 222 222 222 222 222 222 222 222 222 222 222 222 222 222 222 222 222 222 222 213 214 214 214 214 214 214 214 214 214 214 214 215 222 222 222 232 
231 222 222 222 222 222 222 222 222 222 222 222 222 222 222 222 222 222 222 222 222 222 222 222 222 222 222 222 222 222 213 214 214 243 217 217 217 217 217 217 217 217 217 217 217 218 222 222 222 232 
231 222 222 222 222 222 222 222 222 222 222 222 222 222 222 222 222 222 222 222 222 222 222 222 222 222 222 222 222 222 216 217 217 217 255 255 255 255 255 255 255 255 255 255 217 218 222 222 222 232 
231 222 222 222 222 222 222 222 222 222 222 222 222 222 222 222 222 222 222 222 222 222 222 222 222 222 222 222 222 213 243 217 217 217 255 217 217 217 217 217 217 217 217 217 217 218 222 222 222 232 
231 222 222 222 222 222 222 222 222 222 222 222 222 222 222 222 222 222 222 222 222 222 222 222 222 222 222 222 222 216 217 217 217 217 255 217 217 217 240 241 217 217 217 217 217 218 222 222 222 232 
231 222 222 222 222 222 222 222 222 222 222 222 222 222 222 222 222 223 223 224 225 226 227 223 223 223 222 222 222 216 217 217 217 217 255 217 217 217 242 243 217 217 217 217 217 218 222 222 222 232 
231 222 222 222 222 222 222 222 222 222 222 222 222 222 222 214 214 214 214 214 214 214 214 214 214 214 214 214 214 243 217 217 217 217 255 217 217 217 217 217 217 217 217 217 217 218 222 222 222 232 
231 222 222 222 222 222 222 222 222 222 222 213 214 214 243 217 217 217 217 217 217 217 217 217 217 217 217 217 217 217 217 217 217 217 255 217 217 217 217 217 217 217 217 217 217 218 222 222 222 232 
231 222 222 222 222 222 222 222 222 222 222 216 217 217 217 217 217 217 217 217 217 217 217 217 217 217 217 217 217 217 255 255 255 255 255 217 217 217 217 217 217 217 217 217 217 218 222 222 222 232 
231 222 222 222 222 222 222 222 222 222 222 243 217 217 217 217 217 217 217 217 217 217 217 217 217 217 217 217 217 217 255 217 217 217 217 217 217 217 217 217 217 217 217 217 217 218 222 222 222 232 
231 222 222 222 222 222 222 222 222 222 216 217 217 217 217 217 217 217 217 217 217 217 217 217 217 217 217 217 217 217 255 217 217 217 240 220 220 220 220 220 220 220 220 220 220 221 222 222 222 232 
231 222 222 222 222 222 222 222 222 222 216 217 217 217 217 217 217 217 217 217 217 217 217 240 241 217 217 217 217 217 255 217 217 217 218 222 222 222 222 222 222 223 222 222 222 222 222 222 222 232 
231 222 222 222 222 222 222 222 222 222 219 220 241 217 217 217 217 217 217 217 217 217 217 242 243 217 217 217 217 217 255 217 217 217 218 222 223 222 222 222 222 222 222 222 222 222 222 222 222 232 
231 222 222 222 222 222 222 222 222 222 222 222 219 220 220 241 217 217 217 217 217 217 217 217 217 217 217 217 217 217 255 217 217 217 218 222 222 222 222 222 222 222 222 222 222 223 222 222 222 232 
231 222 222 222 222 222 222 222 222 222 225 225 225 222 222 216 217 217 217 217 217 217 217 217 217 217 217 217 217 217 255 217 217 217 218 222 222 222 222 222 222 222 222 222 222 222 222 222 222 232 
231 222 222 222 222 222 222 223 222 222 222 222 213 214 214 243 217 217 217 217 217 217 217 217 217 217 217 217 217 217 255 217 217 217 218 222 222 222 222 222 222 222 222 222 222 222 222 222 222 232 
231 222 222 222 222 222 222 222 222 222 225 225 216 217 217 217 217 217 217 217 217 217 217 217 217 217 217 217 217 217 255 217 217 217 218 223 222 223 224 225 226 227 222 222 222 222 222 222 222 232 
231 222 222 222 222 222 222 222 222 225 225 222 216 217 217 217 217 217 217 217 217 217 217 217 217 217 217 217 217 255 255 255 255 255 218 222 222 222 222 222 222 222 222 222 222 222 222 222 222 232 
231 222 222 222 222 222 222 222 222 222 222 223 216 217 217 217 217 217 217 217 217 217 217 217 217 217 217 217 247 244 247 217 217 255 218 222 222 222 222 222 222 222 222 222 222 222 222 222 222 232 
231 222 222 222 222 222 222 222 225 222 222 213 243 217 217 217 217 217 240 220 220 220 220 220 241 217 217 217 247 247 247 217 217 255 218 222 222 222 222 222 222 222 222 222 222 222 222 222 222 232 
231 222 222 222 222 222 222 222 223 223 223 216 217 217 217 217 217 217 218 222 222 222 225 222 216 217 217 217 217 217 217 217 217 255 248 249 249 249 249 249 222 222 222 222 222 222 222 222 222 232 
231 222 222 222 222 222 222 222 213 214 214 243 217 217 217 217 240 220 221 222 222 222 222 223 219 220 220 220 220 220 220 220 220 220 221 222 222 222 222 249 222 222 222 222 222 222 222 222 222 232 
231 222 222 222 222 222 222 222 216 217 217 217 217 217 217 217 218 222 222 222 222 226 226 222 222 222 225 225 223 222 225 222 222 222 222 225 222 222 213 250 214 214 214 214 214 214 215 222 222 232 
231 222 222 222 222 222 222 222 216 217 217 217 217 217 217 240 221 222 222 223 226 226 222 222 222 226 226 222 222 222 222 223 227 222 222 222 222 222 216 255 247 247 247 247 247 217 218 222 222 232 
231 222 222 222 222 222 222 222 216 217 217 217 217 217 217 218 222 222 222 222 226 227 227 227 227 227 226 226 226 222 222 222 227 222 213 214 214 214 243 255 247 251 251 251 247 217 218 222 222 232 
231 222 222 222 222 222 222 222 216 217 217 217 217 217 217 218 222 225 222 222 222 227 226 223 223 227 227 227 227 227 222 227 227 222 216 217 217 217 217 255 247 251 252 251 247 217 242 215 222 232 
231 222 222 222 222 222 222 222 216 217 217 217 217 217 217 218 222 222 222 222 227 227 226 226 222 223 222 222 222 227 227 227 223 222 216 217 217 217 217 255 247 251 251 251 247 217 217 218 222 232 
231 222 222 222 222 222 222 222 216 217 217 217 217 217 217 218 222 223 222 222 227 222 225 222 222 225 222 222 223 222 223 222 223 222 216 217 217 217 217 255 247 251 251 251 247 217 217 218 222 232 
231 222 222 222 222 222 222 222 216 217 217 217 217 217 217 242 214 214 214 215 222 223 222 223 222 223 223 223 223 222 222 222 222 223 216 217 217 217 217 255 247 247 251 247 247 217 217 218 222 232 
231 222 222 222 222 222 222 222 216 217 217 217 217 217 217 217 217 217 217 242 214 214 214 214 214 214 214 214 214 214 214 214 214 214 243 217 217 217 217 255 255 255 255 217 217 217 217 218 222 232 
231 222 222 222 222 222 222 222 216 217 217 217 217 217 217 217 217 217 217 217 217 217 217 217 217 217 217 217 217 217 217 217 217 217 217 217 217 217 217 217 217 217 217 217 217 217 217 218 222 232 
231 222 222 222 222 222 222 222 216 217 217 217 217 217 217 217 217 217 217 217 217 217 217 217 217 217 217 217 217 217 217 217 217 217 217 217 217 217 217 217 217 217 217 217 217 217 217 218 222 232 
231 222 222 222 222 222 222 222 216 217 217 217 217 217 217 217 217 217 217 217 217 217 217 217 217 217 217 217 217 217 217 217 217 217 217 217 217 217 217 217 217 217 217 217 217 217 217 218 222 232 
231 222 222 222 222 222 222 222 219 220 220 220 220 220 220 220 220 220 220 220 220 220 220 220 220 220 220 220 220 220 220 220 220 220 220 220 220 220 220 220 220 220 220 220 220 220 220 221 222 232 
231 222 222 222 222 222 222 222 222 222 222 222 222 222 222 222 222 222 222 222 222 222 222 222 222 222 222 222 222 222 222 222 222 222 222 222 222 222 222 222 222 222 222 222 222 222 222 222 222 232 
231 222 222 222 222 222 222 222 222 222 222 222 222 222 222 222 222 222 222 222 222 222 222 222 222 222 222 222 222 222 222 222 222 222 222 222 222 222 222 222 222 222 222 222 222 222 222 222 222 232 
231 222 222 222 222 222 222 222 222 222 222 222 222 222 222 222 222 222 222 222 222 222 222 222 222 222 222 222 222 222 222 222 222 222 222 222 222 222 222 222 222 222 222 222 222 222 222 222 222 232 
231 222 222 222 222 222 222 222 222 222 222 222 222 222 222 222 222 222 222 222 222 222 222 222 222 222 222 222 222 222 222 222 222 222 222 222 222 222 222 222 222 222 222 222 222 222 222 222 222 232 
231 222 222 222 222 222 222 222 222 222 222 222 222 222 222 222 222 222 222 222 222 222 222 222 222 222 222 222 222 222 222 222 222 222 222 222 222 222 222 222 222 222 222 222 222 222 222 222 222 232 
231 222 222 222 222 222 222 222 222 222 222 222 222 222 222 222 222 222 222 222 222 222 222 222 222 222 222 222 222 222 222 222 222 222 222 222 222 222 222 222 222 222 222 222 222 222 222 222 222 232 
231 222 222 222 222 222 222 222 222 222 222 222 222 222 222 222 222 222 222 222 222 222 222 222 222 222 222 222 222 222 222 222 222 222 222 222 222 222 222 222 222 222 222 222 222 222 222 222 222 232 
231 222 222 222 222 222 222 222 222 222 222 222 222 222 222 222 222 222 222 222 222 222 222 222 222 222 222 222 222 222 222 222 222 222 222 222 222 222 222 222 222 222 222 222 222 222 222 222 222 232 
233 234 234 234 234 234 234 234 234 234 234 234 234 234 234 234 234 234 234 234 234 234 234 234 234 234 234 234 234 234 234 234 234 234 234 234 234 234 234 234 234 234 234 234 234 234 234 234 234 235 
