15 16 16 16 16 16 16 16 16 16 16 16 16 16 16 16 16 16 16 16 16 16 16 16 16 16 16 16 16 16 16 16 16 16 16 16 16 16 16 16 16 16 16 16 16 16 16 16 16 17 
18 9 9 9 9 9 9 9 9 9 9 9 9 9 9 9 9 9 9 9 9 9 9 9 9 9 9 9 9 9 9 9 9 9 9 9 9 9 9 9 9 9 9 9 9 9 9 9 9 19 
18 9 9 9 9 9 9 9 9 9 9 9 9 9 9 9 9 9 9 9 9 9 9 9 9 9 9 9 9 9 9 9 9 9 9 9 9 9 9 9 9 9 9 9 9 9 9 9 9 19 
18 9 9 9 9 9 9 9 9 9 9 9 9 9 9 9 9 9 9 9 9 9 9 9 9 9 9 9 9 9 9 9 9 9 9 9 9 9 9 9 9 9 9 9 9 9 9 9 9 19 
18 9 9 9 9 9 9 9 9 9 9 9 9 9 9 9 9 9 9 9 9 9 9 9 9 9 9 9 9 9 9 9 9 9 9 9 9 9 9 9 9 9 9 9 9 9 9 9 9 19 
18 9 9 9 9 9 9 9 9 9 9 9 9 9 9 9 9 9 9 9 9 9 9 9 9 9 9 9 9 9 9 9 9 9 10 11 12 13 14 14 9 9 9 9 9 9 9 9 9 19 
18 9 9 9 9 9 9 9 9 9 9 9 9 9 9 9 9 9 9 9 9 9 9 9 9 9 9 9 9 9 9 9 9 9 9 9 9 9 9 9 9 9 9 9 9 9 9 9 9 19 
18 9 9 9 9 9 9 9 9 9 9 9 9 9 9 9 9 9 9 9 9 9 9 9 9 9 9 9 9 9 9 9 9 0 1 1 1 1 1 1 1 1 1 1 1 2 9 9 9 19 
18 9 9 9 9 9 9 9 9 9 9 9 9 9 9 9 9 9 9 9 9 9 9 9 9 9 9 9 9 9 0 1 1 30 4 4 4 4 4 4 4 4 4 4 4 5 9 9 9 19 
18 9 9 9 9 9 9 9 9 9 9 9 9 9 9 9 9 9 9 9 9 9 9 9 9 9 9 9 9 9 3 4 4 4 4 4 4 4 4 4 4 4 4 4 4 5 9 9 9 19 
18 9 9 9 9 9 9 9 9 9 9 9 9 9 9 9 9 9 9 9 9 9 9 9 9 9 9 9 9 0 30 4 4 4 4 4 4 4 4 4 4 4 4 4 4 5 9 9 9 19 
18 9 9 9 9 9 9 9 9 9 9 9 9 9 9 9 9 9 9 9 9 9 9 9 9 9 9 9 9 3 4 4 4 4 4 4 4 4 27 28 4 4 4 4 4 5 9 9 9 19 
18 9 9 9 9 9 9 9 9 9 9 9 9 9 9 9 9 10 10 11 12 13 14 10 10 10 9 9 9 3 4 4 4 4 4 4 4 4 29 30 4 4 4 4 4 5 9 9 9 19 
18 9 9 9 9 9 9 9 9 9 9 9 9 9 9 1 1 1 1 1 1 1 1 1 1 1 1 1 1 30 4 4 4 4 4 4 4 4 4 4 4 4 4 4 4 5 9 9 9 19 
18 9 9 9 9 9 9 9 9 9 9 0 1 1 30 4 4 4 4 4 4 4 4 4 4 4 4 4 4 4 4 4 4 4 4 4 4 4 4 4 4 4 4 4 4 5 9 9 9 19 
18 9 9 9 9 9 9 9 9 9 9 3 4 4 4 4 4 4 4 4 4 4 4 4 4 4 4 4 4 4 4 4 4 4 4 4 4 4 4 4 4 4 4 4 4 5 9 9 9 19 
18 9 9 9 9 9 9 9 9 9 9 30 4 4 4 4 4 4 4 4 4 4 4 4 4 4 4 4 4 4 4 4 4 4 4 4 4 4 4 4 4 4 4 4 4 5 9 9 9 19 
18 9 9 9 9 9 9 9 9 9 3 4 4 4 4 4 4 4 4 4 4 4 4 4 4 4 4 4 4 4 4 4 4 4 27 7 7 7 7 7 7 7 7 7 7 8 9 9 9 19 
18 9 9 9 9 9 9 9 9 9 3 4 4 4 4 4 4 4 4 4 4 4 4 27 28 4 4 4 4 4 4 4 4 4 5 9 9 9 9 9 9 10 9 9 9 9 9 9 9 19 
18 9 9 9 9 9 9 9 9 9 6 7 28 4 4 4 4 4 4 4 4 4 4 29 30 4 4 4 4 4 4 4 4 4 5 9 10 9 9 9 9 9 9 9 9 9 9 9 9 19 
18 9 9 9 9 9 9 9 9 9 9 9 6 7 7 28 4 4 4 4 4 4 4 4 4 4 4 4 4 4 4 4 4 4 5 9 9 9 9 9 9 9 9 9 9 10 9 9 9 19 
18 9 9 9 9 9 9 9 9 9 12 12 12 9 9 3 4 4 4 4 4 4 4 4 4 4 4 4 4 4 4 4 4 4 5 9 9 9 9 9 9 9 9 9 9 9 9 9 9 19 
18 9 9 9 9 9 9 10 9 9 9 9 0 1 1 30 4 4 4 4 4 4 4 4 4 4 4 4 4 4 4 4 4 4 5 9 9 9 9 9 9 9 9 9 9 9 9 9 9 19 
18 9 9 9 9 9 9 9 9 9 12 12 3 4 4 4 4 4 4 4 4 4 4 4 4 4 4 4 4 4 4 4 4 4 5 10 9 10 11 12 13 14 9 9 9 9 9 9 9 19 
18 9 9 9 9 9 9 9 9 12 12 9 3 4 4 4 4 4 4 4 4 4 4 4 4 4 4 4 4 4 4 4 4 4 5 9 9 9 9 9 9 9 9 9 9 9 9 9 9 19 
18 9 9 9 9 9 9 9 9 9 9 10 3 4 4 4 4 4 4 4 4 4 4 4 4 4 4 4 34 31 34 4 4 4 5 9 9 9 9 9 9 9 9 9 9 9 9 9 9 19 
18 9 9 9 9 9 9 9 12 9 9 0 30 4 4 4 4 4 27 7 7 7 7 7 28 4 4 4 34 34 34 4 4 4 5 9 9 9 9 9 9 9 9 9 9 9 9 9 9 19 
18 9 9 9 9 9 9 9 10 10 10 3 4 4 4 4 4 4 5 9 9 9 12 9 3 4 4 4 4 4 4 4 4 4 35 36 36 36 36 36 9 9 9 9 9 9 9 9 9 19 
18 9 9 9 9 9 9 9 0 1 1 30 4 4 4 4 27 7 8 9 9 9 9 10 6 7 7 7 7 7 7 7 7 7 8 9 9 9 9 36 9 9 9 9 9 9 9 9 9 19 
18 9 9 9 9 9 9 9 3 4 4 4 4 4 4 4 5 9 9 9 9 13 13 9 9 9 12 12 10 9 12 9 9 9 9 12 9 9 0 37 1 1 1 1 1 1 2 9 9 19 
18 9 9 9 9 9 9 9 3 4 4 4 4 4 4 27 8 9 9 10 13 13 9 9 9 13 13 9 9 9 9 10 14 9 9 9 9 9 3 4 4 4 4 4 4 4 5 9 9 19 
18 9 9 9 9 9 9 9 3 4 4 4 4 4 4 5 9 9 9 9 13 14 14 14 14 14 13 13 13 9 9 9 14 9 0 1 1 1 30 4 4 4 4 4 4 4 5 9 9 19 
18 9 9 9 9 9 9 9 3 4 4 4 4 4 4 5 9 12 9 9 9 14 13 10 10 14 14 14 14 14 9 14 14 9 3 4 4 4 4 4 4 4 4 4 4 4 29 2 9 19 
18 9 9 9 9 9 9 9 3 4 4 4 4 4 4 5 9 9 9 9 14 14 13 13 9 10 9 9 9 14 14 14 10 9 3 4 4 4 4 4 4 4 4 4 4 4 4 5 9 19 
18 9 9 9 9 9 9 9 3 4 4 4 4 4 4 5 9 10 9 9 14 9 12 9 9 12 9 9 10 9 10 9 10 9 3 4 4 4 4 4 27 7 28 4 4 4 4 5 9 19 
18 9 9 9 9 9 9 9 3 4 4 4 4 4 4 29 1 1 1 2 9 10 9 10 9 10 10 10 10 9 9 9 9 10 3 4 4 4 4 4 5 10 3 4 4 4 4 5 9 19 
18 9 9 9 9 9 9 9 3 4 4 4 4 4 4 4 4 4 4 29 1 1 1 1 1 1 1 1 1 1 1 1 1 1 30 4 4 4 4 4 29 1 30 4 4 4 4 5 9 19 
18 9 9 9 9 9 9 9 3 4 4 4 4 4 4 4 4 4 4 4 4 4 4 4 4 4 4 4 4 4 4 4 4 4 4 4 4 4 4 4 4 4 4 4 4 4 4 5 9 19 
18 9 9 9 9 9 9 9 3 4 4 4 4 4 4 4 4 4 4 4 4 4 4 4 4 4 4 4 4 4 4 4 4 4 4 4 4 4 4 4 4 4 4 4 4 4 4 5 9 19 
18 9 9 9 9 9 9 9 3 4 4 4 4 4 4 4 4 4 4 4 4 4 4 4 4 4 4 4 4 4 4 4 4 4 4 4 4 4 4 4 4 4 4 4 4 4 4 5 9 19 
18 9 9 9 9 9 9 9 6 7 7 7 7 7 7 7 7 7 7 7 7 7 7 7 7 7 7 7 7 7 7 7 7 7 7 7 7 7 7 7 7 7 7 7 7 7 7 8 9 19 
18 9 9 9 9 9 9 9 9 9 9 9 9 9 9 9 9 9 9 9 9 9 9 9 9 9 9 9 9 9 9 9 9 9 9 9 9 9 9 9 9 9 9 9 9 9 9 9 9 19 
18 9 9 9 9 9 9 9 9 9 9 9 9 9 9 9 9 9 9 9 9 9 9 9 9 9 9 9 9 9 9 9 9 9 9 9 9 9 9 9 9 9 9 9 9 9 9 9 9 19 
18 9 9 9 9 9 9 9 9 9 9 9 9 9 9 9 9 9 9 9 9 9 9 9 9 9 9 9 9 9 9 9 9 9 9 9 9 9 9 9 9 9 9 9 9 9 9 9 9 19 
18 9 9 9 9 9 9 9 9 9 9 9 9 9 9 9 9 9 9 9 9 9 9 9 9 9 9 9 9 9 9 9 9 9 9 9 9 9 9 9 9 9 9 9 9 9 9 9 9 19 
18 9 9 9 9 9 9 9 9 9 9 9 9 9 9 9 9 9 9 9 9 9 9 9 9 9 9 9 9 9 9 9 9 9 9 9 9 9 9 9 9 9 9 9 9 9 9 9 9 19 
18 9 9 9 9 9 9 9 9 9 9 9 9 9 9 9 9 9 9 9 9 9 9 9 9 9 9 9 9 9 9 9 9 9 9 9 9 9 9 9 9 9 9 9 9 9 9 9 9 19 
18 9 9 9 9 9 9 9 9 9 9 9 9 9 9 9 9 9 9 9 9 9 9 9 9 9 9 9 9 9 9 9 9 9 9 9 9 9 9 9 9 9 9 9 9 9 9 9 9 19 
18 9 9 9 9 9 9 9 9 9 9 9 9 9 9 9 9 9 9 9 9 9 9 9 9 9 9 9 9 9 9 9 9 9 9 9 9 9 9 9 9 9 9 9 9 9 9 9 9 19 
20 21 21 21 21 21 21 21 21 21 21 21 21 21 21 21 21 21 21 21 21 21 21 21 21 21 21 21 21 21 21 21 21 21 21 21 21 21 21 21 21 21 21 21 21 21 21 21 21 22 
