15 16 16 16 16 16 16 16 16 16 16 16 16 16 16 16 16 16 16 16 16 16 16 16 16 16 16 16 16 16 16 16 16 16 16 16 16 16 16 16 16 16 16 16 16 16 16 16 17
18 2229 22214 2229 2229 2229 2229 2229 2229 2229 2229 2229 2229 2229 2229 2229 11 2229 2229 2229 2229 2229 2229 2229 2229 19
18 2229 2229 14 2229 2229 2229 14 2229 2229 2229 2229 2229 2229 2229 2229 2229 2229 2229 2229 13 2229 2229 2229 2229 2229 19
18 2229 2229 2229 2229 2229 2229 2229 2229 2229 2229 2229 2229 2229 12 2229 2229 2229 2229 2229 2229 2229 2229 2229 2229 19
18 2229 2229 2229 10 2229 2229 2229 2229 2229 2229 2229 2229 2229 2229 2229 2229 2229 22211 2229 2229 2229 2229 2229 2229 19
18 2229 2229 2229 2229 2229 2229 2229 2229 2229 2229 2229 2229 2229 2229 2229 2229 2229 2229 2229 2229 2229 2229 2229 22219
18 2229 2229 2229 10 2229 2229 2229 2229 2229 2229 2229 2229 2229 2229 22210 2229 2229 2229 2229 2229 2229 2229 2229 2229 19
18 2229 13 2229 2229 2229 2229 2229 2229 11 2229 2229 2229 2229 2229 2229 2229 2229 2229 2229 2229 2229 2229 2229 2229 22219
18 2229 2229 2229 213 1 1 1 1 1 1 1 1 1 1 1 1 1 1 1 1 1 1 1 1 1 1 1 1 1 1 1 1 1 1 1 1 1 2 2229 2229 2229 19
18 2229 2229 2229 3 4 4 4 4 4 4 4 4 4 4 4 4 4 4 4 4 4 4 4 4 4 4 4 4 4 4 4 4 4 4 4 4 4 5 2229 2229 2229 19
18 2229 2229 2229 3 4 4 4 4 4 4 4 4 4 4 4 4 4 4 4 4 4 4 4 4 4 4 4 4 4 4 4 4 4 4 4 4 4 5 2229 2229 2229 19
18 2229 2229 2229 3 4 4 4 4 4 4 4 4 4 4 4 4 4 4 4 4 4 4 4 4 4 4 4 4 4 4 4 4 4 4 4 4 4 5 2229 2229 2229 19
18 2229 2229 2229 3 4 4 4 4 4 4 4 4 4 4 4 4 4 4 4 4 4 4 4 4 4 4 4 4 4 4 4 4 4 4 4 4 4 5 2229 2229 2229 19
18 2229 2229 2229 3 4 4 4 4 4 4 4 4 4 4 4 4 4 4 4 4 4 4 4 4 4 4 4 4 4 4 4 4 4 4 4 4 4 5 2229 2229 2229 19
18 2229 2229 2229 3 4 4 4 4 4 4 4 4 4 4 4 4 4 4 4 4 4 4 4 4 4 4 4 4 4 4 4 4 4 4 4 4 4 5 2229 2229 2229 19
18 2229 2229 2229 3 4 4 4 4 4 4 4 4 4 4 4 4 4 4 4 4 4 4 4 4 4 4 4 4 4 4 4 4 4 4 4 4 4 5 2229 2229 2229 19
18 2229 2229 2229 3 4 4 4 4 4 4 4 4 4 4 4 4 4 4 4 4 4 4 4 4 4 4 4 4 4 4 4 4 4 4 4 4 4 5 2229 2229 2229 19
18 2229 2229 2229 3 4 4 4 4 4 4 4 4 4 4 4 4 4 4 4 4 4 4 4 4 4 4 4 4 4 4 4 4 4 4 4 4 4 5 2229 2229 2229 19
18 2229 2229 2229 3 4 4 4 4 4 4 4 4 4 4 4 4 4 4 4 4 4 4 4 4 4 4 4 4 4 4 4 4 4 4 4 4 4 5 2229 2229 2229 19
18 2229 2229 2229 3 4 4 4 4 4 4 4 4 4 4 4 4 4 4 4 4 4 4 4 4 4 4 4 4 4 4 4 4 4 4 4 4 4 5 2229 2229 2229 19
18 2229 2229 2229 3 4 4 4 4 4 4 4 4 4 4 4 4 4 4 4 4 4 4 4 4 4 4 4 4 4 4 4 4 4 4 4 4 4 5 2229 2229 2229 19
18 2229 2229 2229 3 4 4 4 4 4 4 4 4 4 4 4 4 4 4 4 4 4 4 4 4 4 4 4 4 4 4 4 4 4 4 4 4 4 5 2229 2229 2229 19
18 2229 2229 2229 3 4 4 4 4 4 4 4 4 4 4 4 4 4 4 4 4 4 4 4 4 4 4 4 4 4 4 4 4 4 4 4 4 4 5 2229 2229 2229 19
18 2229 2229 2229 3 4 4 4 4 4 4 4 4 4 4 4 4 4 4 4 4 4 4 4 4 4 4 4 4 4 4 4 4 4 4 4 4 4 5 2229 2229 2229 19
18 2229 2229 2229 3 4 4 4 4 4 4 4 4 4 4 4 4 4 4 4 4 4 4 4 4 4 4 4 4 4 4 4 4 4 4 4 4 4 5 2229 2229 2229 19
18 2229 2229 2229 3 4 4 4 4 4 4 4 4 4 4 4 4 4 4 4 4 4 4 4 4 4 4 4 4 4 4 4 4 4 4 4 4 4 5 2229 2229 2229 19
18 2229 2229 2229 3 4 4 4 4 4 4 4 4 4 4 4 4 4 4 4 4 4 4 4 4 4 4 4 4 4 4 4 4 4 4 4 4 4 5 2229 2229 2229 19
18 2229 2229 2229 3 4 4 4 4 4 4 4 4 4 4 4 4 4 4 4 4 4 4 4 4 4 4 4 4 4 4 4 4 4 4 4 4 4 5 2229 2229 2229 19
18 2229 2229 2229 3 4 4 4 4 4 4 4 4 4 4 4 4 4 4 4 4 4 4 4 4 4 4 4 4 4 4 4 4 4 4 4 4 4 5 2229 2229 2229 19
18 2229 2229 2229 3 4 4 4 4 4 4 4 4 4 4 4 4 4 4 4 4 4 4 4 4 4 4 4 4 4 4 4 4 4 4 4 4 4 5 2229 2229 2229 19
18 2229 2229 2229 3 4 4 4 4 4 4 4 4 4 4 4 4 4 4 4 4 4 4 4 4 4 4 4 4 4 4 4 4 4 4 4 4 4 5 2229 2229 2229 19
18 2229 2229 2229 3 4 4 4 4 4 4 4 4 4 4 4 4 4 4 4 4 4 4 4 4 4 4 4 4 4 4 4 4 4 4 4 4 4 5 2229 2229 2229 19
18 2229 2229 2229 3 4 4 4 4 4 4 4 4 4 4 4 4 4 4 4 4 4 4 4 4 4 4 4 4 4 4 4 4 4 4 4 4 4 5 2229 2229 2229 19
18 2229 2229 2229 3 4 4 4 4 4 4 4 4 4 4 4 4 4 4 4 4 4 4 4 4 4 4 4 4 4 4 4 4 4 4 4 4 4 5 2229 2229 2229 19
18 2229 2229 2229 3 4 4 4 4 4 4 4 4 4 4 4 4 4 4 4 4 4 4 4 4 4 4 4 31 4 4 4 4 4 4 4 4 4 5 2229 2229 2229 19
18 2229 2229 2229 3 4 4 4 4 4 4 4 4 4 4 4 4 4 4 4 4 4 4 4 4 4 4 4 4 4 4 4 4 4 4 4 4 4 5 2229 2229 2229 19
18 2229 2229 2229 3 4 4 4 4 4 4 4 4 4 4 4 4 4 4 4 4 4 4 4 4 4 4 4 4 4 4 4 4 4 4 4 4 4 5 2229 2229 2229 19
18 2229 2229 2229 3 4 4 4 4 4 4 4 4 4 4 4 4 4 4 4 4 4 4 4 4 4 4 4 4 4 4 4 4 4 4 4 4 4 5 2229 2229 2229 19
18 2229 2229 2229 3 4 4 4 4 4 4 4 4 4 4 4 4 4 4 4 4 4 4 4 4 4 4 4 4 4 4 4 4 4 4 4 4 4 5 2229 2229 2229 19
18 2229 2229 2229 3 4 4 4 4 4 4 4 4 4 4 4 4 4 4 4 4 4 4 4 4 4 4 4 4 4 4 4 4 4 4 4 4 4 5 2229 2229 2229 19
18 2229 2229 2229 3 4 4 4 4 4 4 4 4 4 4 4 4 4 4 4 4 4 4 4 4 4 4 4 4 4 4 4 4 4 4 4 4 4 5 2229 2229 2229 19
18 2229 2229 2229 6 7 7 7 7 7 7 7 7 7 7 7 7 7 7 7 7 7 7 7 7 7 7 7 7 7 7 7 7 7 7 7 7 7 8 2229 2229 2229 19
18 2229 2229 2229 2229 2229 2229 2229 2229 2229 2229 2229 2229 2229 2229 2229 2229 2229 2229 2229 2229 2229 2229 2229 22219
18 2229 2229 2229 2229 2229 2229 2229 2229 2229 2229 2229 2229 2229 2229 2229 2229 2229 2229 2229 2229 2229 2229 2229 22219
18 2229 2229 2229 2229 2229 2229 2229 2229 2229 2229 2229 2229 2229 2229 2229 2229 2229 2229 2229 2229 2229 2229 2229 22219
18 2229 2229 2229 2229 2229 2229 2229 2229 2229 2229 2229 2229 2229 2229 2229 2229 2229 2229 2229 2229 2229 2229 2229 22219
18 2229 2229 2229 2229 2229 2229 2229 2229 2229 2229 2229 2229 2229 2229 2229 2229 2229 2229 2229 2229 2229 2229 2229 22219
18 2229 2229 2229 2229 2229 2229 2229 2229 2229 2229 2229 2229 2229 2229 2229 2229 2229 2229 2229 2229 2229 2229 2229 22219
18 2229 2229 2229 2229 2229 2229 2229 2229 2229 2229 2229 2229 2229 2229 2229 2229 2229 2229 2229 2229 2229 2229 2229 22219
20 21 21 21 21 21 21 21 21 21 21 21 21 21 21 21 21 21 21 21 21 21 21 21 21 21 21 21 21 21 21 21 21 21 21 21 21 21 21 21 21 21 21 21 21 21 21 21 22